# 单字全码
缤	bbaaoo
濒	bbaivi
滨	bbaooa
髌	bbiaoo
豳	bbiavu
傧	bbiooa
镔	bbiooo
摈	bbiuoo
宾	bbooui
斌	bbovvv
邠	bbuoai
膑	bbuooa
鬓	bbvioo
槟	bbvooa
殡	bbvuoo
玢	bbvvuo
彬	bbvvuu
骉	bcaaaa
骠	bcaavi
瀌	bcaovu
婊	bcauvv
幖	bciavi
藨	bciiov
蔈	bciivi
镳	bcioov
儦	bciova
镖	bciovi
摽	bciuvi
彪	bcivuu
俵	bcivvi
裱	bcoavv
熛	bcouvi
瘭	bcovvi
飚	bcuaou
飑	bcuaua
鳔	bcuavi
膘	bcuvia
脿	bcuvvi
髟	bcviuu
杓	bcvuao
飙	bcvuua
表	bcvvua
标	bcvvvi
别	bdoaii
憋	bdouoa
蹩	bdouoi
鳖	bdouua
瘪	bdovui
绊	bfaaou
阪	bfaiuu
湴	bfaouv
办	bfauoo
蝂	bfiaui
钣	bfiouu
伴	bfiouv
拌	bfiuou
扮	bfiuuo
扳	bfiuuu
搬	bfiuuu
昄	bfoiuu
粄	bfouu
半	bfouvv
𨭉	bfovio
瓣	bfovuu
瘢	bfovuu
癍	bfovvv
版	bfuiuu
攽	bfuouv
颁	bfuovu
般	bfuuua
舨	bfuuuu
靽	bfviou
坂	bfvouu
板	bfvuua
班	bfvvou
斑	bfvvov
屏	bgavou
蛃	bgiavi
摒	bgiuav
昺	bgoivi
炳	bgouvi
并	bgouvv
冰	bgovaa
禀	bgovia
病	bgovvi
饼	bguaou
兵	bguiuo
秉	bguvav
邴	bgviai
丙	bgviau
槟	bgvooa
柄	bgvvia
败	bhaouv
伯	bhiuia
摆	bhiuia
捭	bhiuui
掰	bhiuuo
拜	bhiuvv
佰	bhivui
呗	bhoaoo
白	bhuiav
稗	bhuvui
柏	bhvuia
百	bhvuoi
蔀	bjiiov
卜	bjioo
堡	bjiovo
钚	bjiovu
钸	bjiovu
捕	bjiuvi
步	bjiviu
补	bjoaio
卟	bjoioo
晡	bjoivi
怖	bjoovu
部	bjovai
哺	bjovia
瓿	bjovva
簿	bjuvav
醭	bjviii
逋	bjvioa
埗	bjvoiv
埠	bjvoui
埔	bjvovi
布	bjvuia
不	bjvuio
纰	bkaava
陛	bkaiva
泌	bkaoao
赑	bkaoao
濞	bkauia
婢	bkauui
妣	bkauva
滗	bkauvo
嬖	bkavau
沘	bkavau
避	bkavoa
屄	bkavoo
襞	bkavov
辟	bkavov
臂	bkavuu
壁	bkavvo
弼	bkavvu
璧	bkavvv
睥	bkiaui
髀	bkiaui
畀	bkiavu
薜	bkiiav
苾	bkiioa
蔽	bkiiou
萆	bkiiui
蓖	bkiiui
荸	bkiiuo
荜	bkiiva
佖	bkioao
铋	bkiooa
俾	bkiuia
邲	bkoaai
诐	bkoaau
必	bkoaou
裨	bkoaui
跸	bkoiva
闭	bkoivi
咇	bkooao
愎	bkoouv
鄙	bkouai
敝	bkouuv
弊	bkouvu
吡	bkovau
哔	bkovau
痹	bkovia
庳	bkovui
庇	bkovva
匕	bkuaa
狴	bkuava
鲾	bkuavo
币	bkuiai
鼻	bkuiia
贲	bkuoao
彼	bkuuau
舭	bkuuva
箅	bkuvia
秘	bkuvoa
馝	bkuvoa
篦	bkuvui
笔	bkuvuv
秕	bkuvva
筚	bkuvva
毖	bkvaoa
比	bkvaua
毕	bkvauo
坒	bkvavo
毙	bkvavu
逼	bkvooa
觱	bkvuua
皕	bkvuvu
珌	bkvvoa
碧	bkvvvu
波	blaaui
驳	blaauo
泊	blauia
浡	blauoo
渤	blauoo
剥	blavii
擘	blaviu
檗	blavvv
嶓	bliauo
菠	bliiaa
薄	bliiav
蕃	bliiuo
卜	blioo
铂	blioui
钵	bliovi
镈	bliovi
钹	bliovu
拨	bliuau
伯	bliuia
播	bliuuo
搏	bliuvi
啵	bloaau
袯	bloaau
跛	bloiau
踣	bloiov
亳	blovuv
鲌	bluaui
饽	bluauo
帛	bluiia
魄	bluiui
勃	bluoau
鹁	bluoua
博	bluovi
脖	bluuoo
舶	bluuui
箔	bluvau
簿	bluvav
膊	bluvia
馞	bluvuo
簸	bluvvi
欂	blviia
僰	blvivi
柏	blvuia
礴	blvuii
桲	blvuoo
磻	blvuuo
砵	blvuvi
玻	blvvau
缏	bmaaiv
编	bmaaoa
𨚕	bmaoai
贬	bmaouo
汴	bmaovi
弁	bmaovu
边	bmauoa
蝙	bmiaoa
萹	bmiioa
苄	bmiiov
抃	bmiuov
便	bmivia
扁	bmoaia
褊	bmoaoa
遍	bmoaoa
昪	bmoiao
忭	bmooov
窆	bmoouo
煸	bmouoa
辫	bmovaa
变	bmovao
卞	bmovio
辩	bmovoa
辨	bmovou
鳊	bmuaoa
笾	bmuvau
鞭	bmviiv
匾	bmvoav
碥	bmvuoa
砭	bmvuuo
畚	bnaoia
苯	bniivi
锛	bniovu
倴	bnivuo
贲	bnuoao
坌	bnuovo
犇	bnuvuv
笨	bnuvvi
本	bnviuo
坋	bnvouo
栟	bnvouv
奔	bnvuuo
绑	bpaavv
浜	bpauiv
蚌	bpiavv
蒡	bpiiov
镑	bpioov
傍	bpiovo
搒	bpiuov
谤	bpoaov
𠳐	bpovvu
膀	bpuovo
塝	bpvoov
彭	bpvouu
榜	bpvov
棓	bpvovo
磅	bpvuov
邦	bpvvai
帮	bpvvia
梆	bpvvvv
棒	bpvvvv
玤	bpvvvv
绷	braauu
崩	briauu
蚌	briavv
镚	brioia
祊	broaov
嘣	broiai
蹦	broiia
迸	brouoa
堋	brvouu
甏	brvova
泵	brvuaa
甭	brvuua
琫	brvvvv
巴	bsaiva
妭	bsauvu
灞	bsavoa
岜	bsiaai
蚆	bsiaai
罢	bsiavo
芭	bsiiai
菝	bsiiiu
茇	bsiivu
钯	bsioai
把	bsiuai
捌	bsiuoa
扒	bsiuuo
拔	bsiuvu
吧	bsoaiv
跋	bsoivu
粑	bsouai
羓	bsouai
叭	bsouoo
疤	bsovai
鲃	bsuaai
鲌	bsuaui
鲅	bsuavu
魃	bsuivu
爸	bsuoai
八	bsuoo
笆	bsuvai
胈	bsuvua
靶	bsviai
坝	bsvoao
霸	bsvovi
朳	bsvuoo
耙	bsvvai
陂	bwaiau
贝	bwaoo
鐾	bwavio
臂	bwavuu
蓓	bwiiio
钡	bwioao
倍	bwiovo
邶	bwivai
悲	bwivoa
北	bwivua
背	bwivuu
辈	bwivva
被	bwoaau
褙	bwoaiv
呗	bwoaoo
悖	bwoouo
焙	bwouov
糒	bwouvi
庳	bwovui
狈	bwuaao
备	bwuaia
惫	bwuaoa
鹎	bwuiua
卑	bwuiuo
孛	bwuoai
勃	bwuoau
鞁	bwviai
鞴	bwvivi
椑	bwvuia
碚	bwvuov
碑	bwvuui
琲	bwvviv
杯	bwvvui
孢	bzaiua
瀑	bzaoiv
剥	bzavii
薄	bziiav
葆	bziiio
苞	bziiua
煲	bzioou
堡	bziovo
保	bziovv
报	bziuai
抱	bziuua
龅	bzivua
褓	bzoaio
曝	bzoioi
趵	bzoiua
暴	bzoivi
宝	bzoovv
爆	bzouoi
炮	bzouua
褒	bzovio
勹	bzuaa
包	bzuaav
刨	bzuaii
饱	bzuaua
鲍	bzuaua
鸨	bzuaua
豹	bzuoua
胞	bzuuaa
雹	bzvoua
枹	bzvuaa
缞	cbaaov
漼	cbaiai
翠	cbaoov
淬	cbaovi
崔	cbiaio
催	cbiiai
萃	cbiiov
摧	cbiuia
悴	cbooov
啐	cboovi
粹	cbouov
衰	cbovia
瘁	cbovov
脆	cbuuav
毳	cbuvuv
榱	cbvovi
璀	cbvvia
凑	cdovvv
腠	cduvvv
辏	cdvavv
楱	cdvvvv
测	ceaaoi
侧	ceiaoi
恻	ceooao
册	ceuaua
策	ceuvvi
坼	cevouu
厕	cevuao
栅	cevuau
骖	cfaaao
参	cfaouu
孱	cfavai
黪	cfiaao
掺	cfiuao
餐	cfivio
粲	cfivou
惨	cfooao
惭	cfoova
灿	cfouia
䅟	cfuvao
残	cfvuvv
蚕	cfvvia
璨	cfvviv
财	chaovi
睬	chiauo
偲	chiiav
蔡	chiiua
菜	chiiuo
踩	choiuo
猜	chuavv
裁	chuoov
彩	chuouu
采	chuovv
才	chviuu
材	chvviu
蔟	cjiiov
促	cjioiv
蹴	cjoiov
粗	cjouia
卒	cjovii
猝	cjuaov
徂	cjuuia
簇	cjuvov
酢	cjviuv
醋	cjvivi
殂	cjvuia
蹙	cjvuoi
泚	ckaivi
赐	ckaooi
伺	ckiavo
茲	ckiia
茈	ckiiiv
茨	ckiiov
莿	ckiivi
佽	ckiovu
雌	ckivio
此	ckivua
祠	ckoaav
词	ckoaav
跐	ckoiiv
呲	ckoivi
兹	ckouaa
慈	ckouoa
糍	ckouou
鹚	ckouua
差	ckouvi
疵	ckoviv
次	ckovua
瓷	ckovva
辞	ckuvov
刺	ckviii
磁	ckvuou
玼	ckvviv
嵯	cliaou
莝	cliiii
锉	clioii
错	cliovi
挫	cliuii
撮	cliuoi
搓	cliuou
措	cliuvi
鹾	clivou
蹉	cloiou
痤	clovii
瘥	clovou
脞	cluiiv
酂	cluvai
矬	cluvii
磋	clvuou
厝	clvuvi
瑳	clvvou
涔	cnaiai
参	cnaouu
岑	cniaio
沧	cpaiaa
仓	cpiaaa
鸧	cpiaua
伧	cpiiaa
苍	cpiiia
藏	cpiivu
舱	cpuuia
臧	cpvuvi
层	cravvv
嶒	criaou
蹭	croiou
噌	crooui
曾	crouia
擦	csiuoo
拆	csiuuu
嚓	csoooa
礤	csvuii
镩	ctiooo
撺	ctiuoo
攒	ctiuuv
蹿	ctoioo
窜	ctooia
爨	ctuivv
汆	ctuoaa
篡	ctuvia
皴	cwaoau
蹲	cwoiou
忖	cwoovi
吋	cwovio
邨	cwvaai
寸	cwvioo
存	cwvuai
村	cwvvio
骢	cyaaui
淙	cyaooa
从	cyiiii
苁	cyiiii
葱	cyiiua
丛	cyiivv
悰	cyoooo
熜	cyouui
匆	cyuauu
囱	cyuiua
枞	cyviii
聪	cyviou
琮	cyvvoo
璁	cyvvui
漕	czavia
螬	cziavi
草	cziioi
操	cziuoo
糙	czouuv
嘈	czovia
肏	czuoia
艚	czuuvi
曹	czvioi
𥕢	czvuvi
槽	czvvia
队	dbaiii
怼	dbaooa
对	dbaovi
镦	dbioov
祋	dboaua
兑	dbouua
憝	dbovoa
敦	dbovuv
追	dbuioa
堆	dbvoio
碓	dbvuio
汈	dcaavv
屌	dcavoi
刁	dcavv
铞	dciooi
钓	dcioua
铫	dciouo
掉	dciuiv
调	dcoaua
叼	dcoavv
吊	dcoiai
窎	dcooua
凋	dcovua
雕	dcuaio
鸟	dcuaoa
鲷	dcuaua
貂	dcuoau
碉	dcvuua
绖	ddaava
陡	ddaivo
叠	ddaoia
蚪	ddiaoo
蝶	ddiavi
蔸	ddiiui
钭	ddiooo
抖	ddiuoo
揲	ddiuvi
佚	ddiuvv
读	ddoauo
谍	ddoavi
昳	ddoiuv
跌	ddoiuv
蹀	ddoivi
斗	ddoouo
窦	ddoouo
咥	ddovao
喋	ddovii
痘	ddovvo
鲽	dduavi
兜	dduiua
牒	dduivi
都	dduoai
䏲	dduoua
爹	dduoua
耋	dduova
瓞	dduuuv
迭	dduvoa
篼	dduvui
逗	ddvooa
豆	ddvoou
垤	ddvova
堞	ddvovi
碟	ddvuvi
楪	ddvvii
锝	deiooi
嘚	deouui
的	deuiua
得	deuuoi
德	deuuuo
地	devoai
蛋	dfaiia
疍	dfaioi
赕	dfaoou
淡	dfaoui
澹	dfauav
弹	dfavou
眈	dfiaoa
萏	dfiiua
但	dfioiv
儋	dfiuav
担	dfiuoi
掸	dfiuou
诞	dfoaui
旦	dfoivv
惮	dfooou
憺	dfooua
啖	dfooui
郸	dfouai
单	dfouia
亶	dfovia
疸	dfovoi
瘅	dfovou
丹	dfuaov
胆	dfuoiv
膻	dfuovi
氮	dfuvou
箪	dfuvou
聃	dfviia
耽	dfvioa
石	dfvuoo
殚	dfvuou
鼎	dgiaav
町	dgiavi
盯	dgiavi
萣	dgiioo
锭	dgiooo
铤	dgiouv
钉	dgiovi
仃	dgivii
订	dgoavi
啶	dgoooa
定	dgoovi
叮	dgovii
疔	dgovvi
腚	dguooa
丁	dgvii
耵	dgvivi
酊	dgvivi
顶	dgvivu
碇	dgvuoo
玎	dgvvvi
绐	dhaaao
怠	dhaooa
迨	dhaooa
逮	dhavoa
代	dhivao
贷	dhivao
岱	dhivia
黛	dhivia
袋	dhivov
垈	dhivvo
傣	dhivvv
诒	dhoaao
呔	dhovuo
呆	dhovv
戴	dhuoia
待	dhuuvo
轪	dhvavu
棣	dhvavv
带	dhviia
埭	dhvoav
歹	dhvuao
殆	dhvuao
大	dhvuoo
叇	dhvvav
甙	dhvvii
玳	dhvviv
赌	djaouo
渡	djaovu
妒	djauoa
渎	djauoa
厾	djavoa
髑	djiaia
睹	djiauo
黩	djiauo
芏	djiivo
镀	djioov
督	djivia
读	djoauo
阇	djoiuo
嘟	djouov
度	djovao
独	djuaia
牍	djuiuo
都	djuoai
笃	djuvaa
肚	djuvoo
犊	djuvuo
蠹	djviia
堵	djvouo
椟	djvuoa
毒	djvvaa
杜	djvvoo
缔	dkaaov
翟	dkaoio
滴	dkaovo
涤	dkauao
娣	dkauou
媂	dkauov
嫡	dkauov
迪	dkiaoa
睇	dkiaou
骶	dkiaua
䗖	dkiavi
蒂	dkiiov
荻	dkiiua
菂	dkiiui
镝	dkioov
俤	dkioua
低	dkiuav
提	dkiuoi
抵	dkiuua
禘	dkoaov
谛	dkoaov
诋	dkoaua
踶	dkoioi
蹢	dkoiov
嘀	dkoovo
弟	dkouav
递	dkouoa
羝	dkouua
帝	dkovia
遆	dkovoa
底	dkovua
邸	dkuaai
狄	dkuaou
氐	dkuava
的	dkuiua
觌	dkuoia
籴	dkuoou
第	dkuvav
笛	dkuvia
敌	dkuvuv
棣	dkvavv
髢	dkviai
鞮	dkvioi
地	dkvoai
堤	dkvooi
坻	dkvoua
柢	dkvuav
䃅	dkvuou
碲	dkvuov
砥	dkvuua
𤧛	dkvvov
玓	dkvvua
杕	dkvvuo
缍	dlaauv
驮	dlaavu
隳	dlaiii
堕	dlaivo
隋	dlaivu
剟	dlaoii
沲	dlauva
铎	dlioao
掇	dliuao
裰	dloaao
咄	dloaii
踱	dloiov
跺	dloiua
惰	dloovu
哆	dlouao
哚	dlouav
度	dlovao
亸	dlovou
饳	dluaai
剁	dluaii
多	dluaua
朵	dluavv
躲	dluiua
舵	dluuoo
㙍	dlvoao
柁	dlvooa
垛	dlvoua
埵	dlvouv
夺	dlvuvi
阽	dmaiiv
淀	dmaooa
滇	dmauoi
殿	dmavua
典	dmiauo
巅	dmiauo
电	dmiavv
佃	dmiiav
钿	dmioia
掂	dmiuov
垫	dmiuvo
点	dmivoo
扂	dmoaiv
踮	dmoiov
惦	dmooov
奠	dmouvu
癜	dmovav
店	dmoviv
癫	dmovuo
甸	dmuaia
颠	dmuovu
簟	dmuvvi
坫	dmvoiv
碘	dmvuia
磹	dmvuvi
玷	dmvviv
琔	dmvvoo
靛	dmvvoo
扽	dniuva
凼	dpaaii
荡	dpiiaa
菪	dpiioo
当	dpioav
铛	dpioio
党	dpioua
挡	dpiuio
裆	dpoaio
谠	dpoaio
宕	dpoovu
筜	dpuvio
档	dpviou
𣗋	dpviou
垱	dpvoio
砀	dpvuau
珰	dpvvio
铥	dqiouv
丢	dquvao
澄	draaou
邓	draoai
凳	draoua
登	draovo
嶝	driaao
瞪	driaao
镫	drioao
噔	droaou
蹬	droiao
戥	droiva
灯	drouvi
簦	druvao
等	druvvo
磴	drvuao
璒	drvvao
溚	dsaiii
沓	dsaoii
妲	dsauoi
迚	dsiaoa
荙	dsiivu
𨱏	dsioii
搭	dsiuii
打	dsiuvi
褡	dsoaii
嗒	dsoiii
跶	dsoivu
怛	dsoooi
惮	dsooou
炟	dsouoi
嗲	dsouou
瘩	dsovii
哒	dsovuo
答	dsuviv
笪	dsuvoi
靼	dsvioi
鞑	dsvivu
垯	dsvovu
达	dsvuoa
大	dsvuoo
耷	dsvuvi
缎	dtaaui
耑	dtiavu
锻	dtioui
煅	dtouui
断	dtouuu
端	dtovia
段	dtuiua
簖	dtuvou
短	dtuvvo
塅	dtvoui
椴	dtvuiv
瑖	dtvvui
沌	dwavai
囤	dwiava
盹	dwiava
镦	dwioov
钝	dwiova
蹲	dwoiou
蹾	dwoiov
惇	dwooov
炖	dwouva
吨	dwovai
敦	dwovuv
遁	dwuuoa
得	dwuuoi
盾	dwuuuo
趸	dwvaoi
顿	dwvavu
墩	dwvoov
礅	dwvuov
砘	dwvuva
洞	dyaiav
峒	dyiaia
岽	dyiava
侗	dyiiav
董	dyiiuv
恫	dyooia
懂	dyooii
咚	dyouao
冻	dyovva
冬	dyuaoo
胴	dyuiav
胨	dyuvai
氡	dyuvua
东	dyvaiu
鸫	dyvaua
垌	dyvoia
硐	dyvuia
栋	dyvvai
动	dyvvau
刀	dzauu
导	dzavvi
帱	dziavv
捣	dziuua
捯	dziuva
倒	dzivao
叨	dzoauu
祷	dzoavv
蹈	dzoiuo
忉	dzooau
悼	dzooiv
道	dzouoa
盗	dzovia
鱽	dzuaau
岛	dzuaia
舠	dzuuau
氘	dzuvui
稻	dzuvuo
到	dzvaii
纛	dzvvia
焘	dzvvoo
水	ebaa
帨	ebiaou
睡	ebiauv
谁	eboaio
说	eboaou
税	ebuvou
绶	edaauo
收	edaiuv
售	ediooo
手	ediuu
授	ediuuo
守	edoovi
首	edouui
兽	edouvo
熟	edovoo
瘦	edovui
狩	eduaoo
受	eduoao
艏	eduuou
寿	edvvvi
涉	eeaivi
赊	eeaoiv
滠	eeavii
蛇	eeiaoo
折	eeiuuu
揲	eeiuvi
摄	eeiuvi
畬	eeivia
畲	eeivia
歙	eeivua
佘	eeivvi
舍	eeivvi
设	eeoaua
社	eeoavo
慑	eeoovi
麝	eeovui
猞	eeuaiv
射	eeuivi
舌	eeuvoo
赦	eevouv
奓	eevuua
奢	eevuuo
厍	eevuva
骟	efaaoa
缮	efaaou
汕	efaiai
陕	efaivo
赡	efaoua
嬗	efauov
姗	efauua
潸	efavvu
山	efiaii
蟮	efiaou
苫	efiiiv
芟	efiiua
钐	efiouu
掺	efiuao
掞	efiuoo
掸	efiuou
擅	efiuov
扇	efoaao
讪	efoaia
禅	efoaou
衫	efoauu
闪	efoiii
晱	efoiou
跚	efoiua
鄯	efouai
糁	efouao
单	efouia
剡	efouii
煽	efouoa
善	efouoo
疝	efovia
颤	efovvu
删	efuaii
鳝	efuaou
鳣	efuaov
膳	efuouv
膻	efuovi
舢	efuuia
墡	efvoou
埏	efvoui
栅	efvuau
杉	efvuuu
珊	efvvua
蟀	egiaov
帅	egiuia
摔	egiuov
率	egovaa
衰	egovia
甩	eguavv
晒	ehoivi
色	ehuaai
筛	ehuviu
酾	ehvivi
纾	ejaaao
书	ejaaio
疏	ejaiov
陎	ejaiuv
淑	ejaivv
赎	ejaouo
婌	ejauiv
恕	ejauoa
姝	ejauuv
漱	ejavia
沭	ejavoo
澍	ejavoo
属	ejavui
蜀	ejiaua
署	ejiauo
墅	ejiavo
蔬	ejiiai
薯	ejiiia
菽	ejiiiv
竖	ejiiov
倏	ejiiua
抒	ejiuao
摅	ejiuiv
鄃	ejiva
叔	ejivao
舒	ejivao
毹	ejivuv
曙	ejoiia
暑	ejoiuo
数	ejouuv
庶	ejovoo
熟	ejovoo
孰	ejovua
塾	ejovvo
殳	ejuaao
鼠	ejuiao
腧	ejuivu
黍	ejuvia
秫	ejuvvo
输	ejvaiv
树	ejvaov
束	ejviav
术	ejvo
述	ejvooa
梳	ejvova
戍	ejvuoo
殊	ejvuuv
琡	ejvviv
枢	ejvvuo
驶	ekaaia
浉	ekaiuv
湿	ekaoii
湜	ekaoiv
始	ekauao
虱	ekauia
屎	ekavou
鸤	ekavua
尸	ekavuu
似	ekiaoi
峙	ekiavo
畤	ekiavo
史	ekiavu
莳	ekiioi
蓍	ekiiuo
食	ekioav
铈	ekioov
势	ekiuau
拾	ekiuiv
逝	ekiuoa
什	ekiuoo
誓	ekiuov
师	ekiuvi
拭	ekiuvv
使	ekivia
仕	ekivoo
侍	ekivov
视	ekoaia
识	ekoaou
谥	ekoaou
祏	ekoav
呞	ekoavo
诗	ekoavo
襫	ekoavv
试	ekoavv
匙	ekoiua
嘘	ekoiva
时	ekoivi
是	ekoivi
实	ekoooo
恃	ekoov
室	ekoova
嗜	ekouov
噬	ekouvo
炻	ekouvu
市	ekovia
施	ekovuv
鲺	ekuaau
蚀	ekuaia
狮	ekuaiu
鲥	ekuaoi
饰	ekuauv
氏	ekuava
鼫	ekuivu
释	ekuoao
十	ekuoo
弑	ekuovv
适	ekuvoa
舐	ekuvua
䏡	ekuvvi
筮	ekuvvi
失	ekuvvu
矢	ekuvvu
轼	ekvavv
贳	ekviao
事	ekviav
世	ekviiv
䴓	ekviua
酾	ekvivi
邿	ekvoai
螫	ekvoia
士	ekvoo
埘	ekvooi
柿	ekvovi
豕	ekvuau
石	ekvuoo
殖	ekvuuo
示	ekvviu
式	ekvviv
奭	ekvvuv
栻	ekvvvi
妁	elauua
蒴	eliiou
铄	elioua
搠	eliuou
说	eloaou
烁	elouua
朔	elouuu
槊	elouvv
硕	elvuvu
骦	emaavi
双	emaoao
孀	emauvo
泷	emavua
鹴	emvoua
霜	emvovi
爽	emvuou
礵	emvuvo
绅	enaaia
渗	enaaov
沈	enaoau
深	enaoau
渖	enaooa
参	enaouu
婶	enauoo
娠	enauvu
屾	eniaia
瞫	eniavi
申	eniavv
伸	eniiav
莘	eniiov
肾	eniiuu
葚	eniivi
什	eniuoo
侁	eniuvi
神	enoaia
谂	enoaio
诜	enoauv
谌	enoavi
呻	enoiav
审	enooia
慎	enoouo
糁	enouao
燊	enouvv
瘆	enovao
哂	enovia
鲹	enuaao
胂	enuiav
身	enuiav
矧	enuvav
甡	enuvuv
甚	enviuo
砷	envuia
蜃	envuia
珅	envvia
椹	envvii
绱	epaaio
汤	epaauu
赏	epioao
尚	epioia
裳	epioov
伤	epiuva
上	epivvv
晌	epoiui
熵	epouov
商	epovia
觞	epuauv
墒	epvoov
垧	epvoui
殇	epvuuv
涮	eqaavu
刷	eqavii
唰	eqoavu
耍	eqvuau
绳	eraaoi
陞	eraiuv
渑	eraoia
圣	eraovo
嵊	eriauv
省	eriuia
昇	eroiuv
晟	eroivu
胜	eruuvv
甥	eruvia
眚	eruvia
剩	eruvii
乘	eruviv
升	eruvui
牲	eruvuv
笙	eruvuv
生	eruvvi
声	ervoai
盛	ervuia
纱	esaaiu
裟	esaiov
鲨	esaiua
沙	esaiuo
莎	esiiai
铩	esiouo
傻	esiuia
啥	esoivv
唼	esoovo
痧	esovai
嗄	esovui
煞	esuaoo
刹	esuoii
杀	esuovv
歃	esuvua
霎	esvoov
砂	esvuiu
杉	esvuuu
厦	esvuvu
涮	etaavu
拴	etiuiv
闩	etoivv
腨	etuiai
栓	etvivv
瞬	ewiauo
谁	ewoaio
吮	ewoaou
顺	ewuivu
舜	ewuoua
楯	ewvuuu
骦	exaavi
双	exaoao
孀	exauvo
泷	exavua
鹴	exvoua
霜	exvovi
爽	exvuou
礵	exvuvo
绍	ezaaau
邵	ezauai
劭	ezauau
召	ezauoo
潲	ezauvi
蛸	eziaio
苕	eziiau
芍	eziiua
捎	eziuio
少	eziuou
哨	ezoiou
烧	ezouva
韶	ezovau
勺	ezuaoo
艄	ezuuio
稍	ezuvio
筲	ezuvio
柖	ezvauo
鞘	ezviio
梢	ezviou
杓	ezvuao
玿	ezvvau
缀	fbaaao
骓	fbaaio
缒	fbaaui
坠	fbaivo
锥	fbioio
隹	fbiovv
揣	fbiuia
惴	fbooia
追	fbuioa
椎	fbviov
赘	fbvvao
覅	fcviua
绉	fdaaua
纣	fdaavi
骤	fdaavi
赒	fdaoua
洲	fdaouo
妯	fdauia
婤	fdauua
帚	fdavia
昼	fdavoi
粥	fdavou
胄	fdiauu
荮	fdiiaa
㑇	fdiuaa
诌	fdoaua
宙	fdooia
咒	fdooua
啁	fdouav
州	fdouoi
皱	fduaau
周	fduavo
繇	fduoua
舟	fduuao
鸼	fduuua
肘	fduvio
籀	fduviu
缶	fduvvi
轴	fdvaia
辀	fdvauu
酎	fdvivi
不	fdvuio
否	fdvuoo
碡	fdvuvv
浙	feaiuu
蔗	feiiov
锗	feiouo
摺	feiuao
蛰	feiuia
蜇	feiuia
晢	feiuoi
哲	feiuoo
折	feiuuu
褶	feoaao
谪	feoaov
褚	feoauo
着	feouia
啫	feouov
䗪	feovia
这	feovoa
遮	feovoa
鹧	feovua
者	feuooi
辙	fevaov
辄	fevavi
赭	fevouo
喆	fevovo
詟	fevuov
磔	fevuua
柘	fevvuo
氾	ffaaaa
贩	ffaouu
泛	ffauoa
帆	ffiaua
幡	ffiauo
畈	ffiauu
范	ffiiaa
藩	ffiiau
蕃	ffiiuo
蘩	ffiiuv
钒	ffioua
蹯	ffoiuo
燔	ffouuo
烦	ffouvu
犯	ffuaaa
凡	ffuaoo
饭	ffuauu
翻	ffuoao
番	ffuoia
反	ffuuao
返	ffuuoa
繁	ffuvaa
墦	ffvouo
矾	ffvuua
樊	ffvuvu
梵	ffvvua
璠	ffvvuo
拽	fgiuia
跩	fgoiia
转	fgvavv
翟	fhaoio
侧	fhiaoi
择	fhiuao
摘	fhiuov
债	fhivvi
砦	fhivvu
宅	fhoouv
窄	fhoouv
寨	fhoovv
瘵	fhovua
斋	fhovvu
祭	fhuavv
绋	fjaaav
驸	fjaaiv
缚	fjaavi
绂	fjaavu
附	fjaiiv
洑	fjaivu
赙	fjaovi
涪	fjaovo
赋	fjaovv
妇	fjauav
浮	fjauoo
㳇	fjauou
滏	fjauou
弗	fjavau
艴	fjavua
幅	fjia
幞	fjiaii
蜉	fjiauo
蝮	fjiauv
佛	fjiava
蝠	fjiavo
罘	fjiavu
蚨	fjiavv
䓛	fjiiav
茀	fjiiav
苻	fjiiiv
茯	fjiiiv
菔	fjiiua
莩	fjiiuo
芾	fjiivi
莆	fjiivi
黼	fjiivi
芣	fjiivu
黻	fjiivu
芙	fjiivv
俯	fjiovu
拂	fjiuav
拊	fjiuiv
俘	fjiuoo
扶	fjiuvv
抚	fjiuvv
傅	fjivia
付	fjivio
伏	fjivuo
讣	fjoaio
袱	fjoaiv
福	fjoavo
祓	fjoavu
跗	fjoiiv
咐	fjoivi
趺	fjoivv
怫	fjooav
宓	fjoooa
富	fjoovo
㕮	fjouou
鄜	fjovai
腐	fjovia
府	fjoviv
呋	fjovvu
呒	fjovvu
负	fjuaao
服	fjuaia
鲋	fjuaiv
凫	fjuaua
孵	fjuauo
鳆	fjuauv
匐	fjuavo
阜	fjuiuo
孚	fjuoai
郛	fjuoai
父	fjuouo
斧	fjuouu
腑	fjuovu
釜	fjuovv
腹	fjuuvo
氟	fjuvav
脯	fjuvia
符	fjuviv
复	fjuvoi
稃	fjuvuo
馥	fjuvuv
簠	fjuvvi
肤	fjuvvu
辅	fjvavi
辐	fjvavo
甫	fjviav
覆	fjviuu
敷	fjviuv
副	fjvoii
赴	fjvoio
砩	fjvuav
桴	fjvuoo
砆	fjvuvv
榑	fjvvia
夫	fjvvuo
琈	fjvvuo
韨	fjvvvu
玞	fjvvvv
麸	fjvvvv
滍	fkaaii
治	fkaaoo
织	fkaaou
纸	fkaaua
彘	fkaauv
骘	fkaiaa
陟	fkaiiv
沚	fkaivi
泜	fkauav
汁	fkauoo
滞	fkavii
咫	fkavou
ㄓ	fkiaiv
帜	fkiaou
置	fkiauo
帙	fkiauv
蜘	fkiauv
蛭	fkiava
峙	fkiavo
畤	fkiavo
芷	fkiiiv
芝	fkiioa
黹	fkiiou
𦭜	fkiiou
茋	fkiiua
锧	fkiouu
铚	fkiova
絷	fkiuaa
贽	fkiuao
挚	fkiuiu
值	fkiuoi
掷	fkiuou
摭	fkiuov
执	fkiuua
扺	fkiuua
指	fkiuua
鸷	fkiuua
侄	fkivao
止	fkiviv
祉	fkoaiv
禔	fkoaoi
之	fkoaoo
识	fkoaou
祇	fkoaua
祗	fkoaua
趾	fkoiiv
踯	fkoiou
蹢	fkoiov
踬	fkoiuu
晊	fkoiva
跱	fkoivo
跖	fkoivu
忮	fkoouo
窒	fkoova
吱	fkouoa
只	fkouoo
痓	fkovva
庤	fkovvo
痔	fkovvo
痣	fkovvo
旨	fkuaoi
炙	fkuaou
觯	fkuaou
氏	fkuava
疐	fkuoai
𨙸	fkuoai
支	fkuoao
直	fkuoia
膣	fkuooa
豸	fkuoou
卮	fkuuaa
脂	fkuuao
胝	fkuuav
徵	fkuuia
肢	fkuuoa
质	fkuuuo
制	fkuvii
稚	fkuvio
雉	fkuvio
智	fkuvoi
知	fkuvoo
稙	fkuvuo
秩	fkuvuv
郅	fkvaai
轵	fkvaou
致	fkvauv
轾	fkvava
至	fkvavo
郦	fkviai
栉	fkviia
职	fkviou
酯	fkviua
址	fkvoiv
志	fkvooa
埴	fkvouo
枳	fkvouo
枝	fkvuoa
植	fkvuoi
榰	fkvuov
殖	fkvuuo
栀	fkvuuv
桎	fkvvao
梽	fkvvoo
濯	flaaov
缴	flaaui
浊	flaiav
淖	flaivi
叕	flaoao
浞	flaoiv
汋	flauao
涿	flavua
佛	fliava
茁	fliiai
著	fliiuo
倬	fliivo
镯	flioia
䦃	flioii
拙	fliuai
擢	fliuao
捉	fliuoi
卓	flivuo
桌	flivvv
禚	floaou
诼	floavu
躅	floiia
晫	floiiv
着	flouia
焯	flouiv
灼	flouua
啄	flovua
酌	flviua
棹	flvivo
棁	flvouo
斫	flvuuu
椓	flvvua
琢	flvvvu
奘	fmaivu
幢	fmiaov
僮	fmiovo
撞	fmiuov
憧	fmooov
妆	fmovau
戆	fmovoa
装	fmovov
壮	fmovvo
庄	fmovvo
状	fmovvu
桩	fmvovu
纷	fnaauo
翂	fnaouo
瀵	fnaouv
汾	fnauoa
𣸣	fnauoi
芬	fniiuo
棻	fniivv
份	fniuoa
偾	fniuov
愤	fnoouo
吩	fnouoa
粉	fnouuo
粪	fnouvi
鲼	fnuauo
鼢	fnuiuo
分	fnuoau
忿	fnuooa
氛	fnuvuo
酚	fnviuo
坟	fnvoov
奋	fnvuia
豮	fnvuuo
焚	fnvvou
棼	fnvvuo
玢	fnvvuo
纺	fpaaov
防	fpaiov
妨	fpauov
蚄	fpiaov
芳	fpiiov
钫	fpioov
仿	fpiova
房	fpoaov
访	fpoaov
昉	fpoiov
邡	fpovai
方	fpovau
放	fpovuv
鲂	fpuaov
肪	fpuova
彷	fpuuov
舫	fpuuov
牥	fpuvov
匚	fpvaa
坊	fpvoov
枋	fpvova
抓	fqiuuu
挝	fqiuvi
爪	fquuio
髽	fqviii
缝	fraaua
赗	fraoia
浲	frauao
沨	frauau
沣	fravvv
峰	friaua
蜂	friaua
崶	friavo
葑	friivo
锋	frioua
俸	frivvv
讽	froaua
烽	frouua
冯	frovaa
疯	frovua
唪	frovvv
凤	fruaao
逢	fruaoa
风	fruauo
封	frvovi
堼	frvovo
枫	frvuau
砜	frvuua
酆	frvvai
丰	frvvvi
奉	frvvvv
溠	fsaouv
发	fsauao
法	fsavoa
渣	fsavoi
罚	fsiaoa
眨	fsiauo
蚱	fsiauv
铡	fsioao
扎	fsiuaa
挓	fsiuoo
拃	fsiuuv
揸	fsiuvo
伐	fsivau
垡	fsivvo
诈	fsoauv
闸	fsoiia
阀	fsoiiv
哳	fsoiuu
咤	fsoooa
怍	fsoouv
鲝	fsouua
炸	fsouuv
吒	fsouva
咋	fsouvi
喋	fsovii
喳	fsovoi
痄	fsovuv
鲊	fsuauv
猹	fsuavo
齇	fsuiiv
齄	fsuivo
乏	fsuoao
劄	fsuvii
乍	fsuviv
筏	fsuviv
札	fsvaa
轧	fsvaaa
查	fsvoiv
榨	fsvooa
霅	fsvoov
栅	fsvuau
砟	fsvuuv
砝	fsvuvo
䃎	fsvuvu
楂	fsvvoi
珐	fsvvvo
赚	ftaoou
僎	ftiaaa
颛	ftiavu
撰	ftiuav
传	ftivva
啭	ftovai
馔	ftuaav
篆	ftuvaa
转	ftvavv
砖	ftvuvv
瑑	ftvvaa
专	ftvvao
绯	fwaaiv
沸	fwaava
淝	fwauai
妃	fwauav
飞	fwauoo
费	fwavao
菲	fwiiiv
芾	fwiivi
镄	fwioav
翡	fwivao
蜚	fwivia
剕	fwivii
非	fwiviv
斐	fwivov
棐	fwivvv
扉	fwoaiv
诽	fwoaiv
啡	fwoivv
悱	fwooiv
废	fwovau
痱	fwoviv
吠	fwovuo
狒	fwuaav
肥	fwuaiv
鲱	fwuaiv
腓	fwuivv
朏	fwuoai
肺	fwuvia
篚	fwuvvi
匪	fwvivv
霏	fwvoiv
榧	fwvviv
奘	fxaivu
幢	fxiaov
僮	fxiovo
撞	fxiuov
憧	fxooov
妆	fxovau
戆	fxovoa
装	fxovov
壮	fxovvo
庄	fxovvo
状	fxovvu
桩	fxvovu
终	fyaaua
盅	fyiaia
忠	fyiaoa
蚣	fyiauo
中	fyiavi
仲	fyiiav
众	fyiiii
茽	fyiiii
钟	fyioia
锺	fyiouv
冢	fyoavu
踵	fyoiuv
忪	fyoouo
衷	fyovia
螽	fyuaia
肿	fyuiav
舯	fyuuia
种	fyuvia
重	fyuvia
柊	fyvuao
沼	fzaauo
召	fzauoo
罩	fziaiv
䓬	fziiiv
钊	fzioii
招	fziuau
找	fziuva
诏	fzoaau
肇	fzoaav
昭	fzoiau
曌	fzoioo
照	fzoioo
啁	fzouav
着	fzouia
嘲	fzouoo
旐	fzovuv
兆	fzuoau
朝	fzuouu
爪	fzuuio
笊	fzuvuu
棹	fzvivo
赵	fzvouo
癸	gbaovv
氿	gbauau
妫	gbauou
姽	gbauua
贵	gbiaao
刿	gbiaii
嶲	gbiaio
眭	gbiavo
归	gbiuav
傀	gbiuia
郐	gbivai
刽	gbivii
诡	gboaua
炅	gboiou
晷	gboiua
跪	gboiua
闺	gboivo
宄	gbooua
廆	gbovui
庋	gbovuo
龟	gbuaia
鲑	gbuavo
鳜	gbuavu
鬼	gbuiao
皈	gbuiuu
簋	gbuvav
筀	gbuvvo
轨	gbvaua
桧	gbvivv
邽	gbvoai
圭	gbvovo
硅	gbvuvo
匦	gbvvai
柜	gbvvav
规	gbvvia
桂	gbvvov
瑰	gbvvui
珪	gbvvvo
鬶	gbvvvo
缑	gdaaia
购	gdaoua
沟	gdauaa
姤	gdauuu
媾	gdauvv
岣	gdiaua
苟	gdiiua
钩	gdioua
佝	gdiuao
拘	gdiuua
诟	gdoauu
勾	gduaao
雊	gduaio
句	gduao
够	gduaua
狗	gduaua
耇	gduoua
笱	gduvua
篝	gduvvv
鞲	gdvivv
彀	gdvoua
垢	gdvouu
构	gdvuaa
枸	gdvuao
觏	gdvvia
遘	gdvvoa
纥	geaauv
隔	geaivo
哿	geauvo
滆	geavoi
蛤	geiaiv
骼	geiaua
虼	geiauv
个	geiii
葛	geiioi
铬	geioua
镉	geiovo
搿	geiuiv
搁	geiuoi
仡	geiuva
合	geivoo
鸽	geivua
颌	geivvu
袼	geoaua
阁	geoiua
割	geooii
咯	geouao
盖	geouia
嗝	geovoi
疙	geovuv
各	geuaoo
胳	geuuao
舸	geuuvo
膈	geuvoi
戈	gevauo
革	geviia
鬲	gevoia
歌	gevoua
圪	gevouv
哥	gevovo
塥	gevovo
格	gevuao
硌	gevuua
澉	gfaavi
绀	gfaavi
淦	gfaioo
㽏	gfaiva
泔	gfavii
敢	gfavuv
苷	gfiivi
擀	gfiuuo
旰	gfoivv
咁	gfovii
赣	gfovua
疳	gfovvi
鳡	gfuavu
乾	gfuouv
肝	gfuvvi
秆	gfuvvv
竿	gfuvvv
橄	gfvavi
甘	gfviiv
酐	gfvivv
坩	gfvovi
赶	gfvovv
尴	gfvuii
感	gfvuoa
矸	gfvuvv
干	gfvvii
柑	gfvvii
杆	gfvvvi
玕	gfvvvv
夬	ggavuo
掴	ggiuia
拐	ggiuoa
怪	ggooao
乖	gguviv
溉	ghaavv
陔	ghaiov
赅	ghaoov
戤	ghauva
改	ghavuv
芥	ghiiiu
荄	ghiiov
钙	ghiovi
该	ghoaov
晐	ghoiov
盖	ghouia
概	ghvavv
丐	ghviva
垓	ghvoov
孤	gjaiuu
汩	gjaoii
沽	gjauoo
瀔	gjauov
姑	gjauuo
崮	gjiaia
蛊	gjiaia
鹘	gjiaua
固	gjiauo
罟	gjiauo
蛄	gjiauo
骨	gjiauu
菰	gjiiai
菇	gjiiau
䓛	gjiiav
蓇	gjiiia
锢	gjioia
钴	gjiouo
估	gjiuoo
雇	gjoaio
诂	gjoauo
咕	gjouoo
呱	gjouua
羖	gjouua
痼	gjovia
馉	gjuaia
鲴	gjuaia
觚	gjuauu
嘏	gjuoav
古	gjuooo
谷	gjuooo
辜	gjuoov
榖	gjuoua
鸪	gjuoua
故	gjuouv
股	gjuuaa
𦙶	gjuuoo
箍	gjuviu
臌	gjuvov
牯	gjuvuo
牿	gjuvuv
轱	gjvauo
贾	gjviao
酤	gjviuo
堌	gjvoia
瞽	gjvoia
毂	gjvoua
鼓	gjvouo
梏	gjvuvi
顾	gjvuvu
涡	glaoia
帼	gliaia
蜾	gliaia
蝈	gliaia
崞	gliaov
国	gliavv
果	gliavv
锅	gliooi
掴	gliuia
呙	gloiau
粿	glouia
馘	glouvo
郭	glovai
裹	glovia
猓	gluaia
馃	gluaia
腘	gluiav
虢	gluoiv
过	glvioa
聒	glviuv
埚	glvooi
椁	glvovo
洸	gmaiou
潢	gmavii
光	gmioua
咣	gmoiou
广	gmovuu
逛	gmuaoa
犷	gmuaov
胱	gmuiou
𨐈	gmvaio
桄	gmviou
垙	gmvoio
珖	gmvvio
艮	gnavva
茛	gniiav
哏	gnoavv
跟	gnoiav
根	gnvavv
亘	gnvoiv
纲	gpaaia
港	gpavii
岗	gpiaia
刚	gpiaii
冈	gpiauo
罡	gpiavi
钢	gpioia
扛	gpiuvi
戆	gpovoa
冮	gpovvi
肛	gpuviv
筻	gpuvvi
缸	gpuvvi
㭎	gpviau
堽	gpvoia
矼	gpvuvi
杠	gpvviv
括	gqiuuv
挂	gqiuvo
褂	gqoavo
诖	gqoavo
剐	gqoiii
寡	gqoovu
呱	gqouua
瓜	gquuao
胍	gquuua
刮	gquvii
鸹	gquvua
卦	gqvoio
坬	gqvouu
栝	gqvuvi
绠	graavi
颈	graovu
浭	gravia
羹	grouou
赓	grovao
庚	grovav
哽	grovia
鹒	grovua
鲠	gruavi
更	grviav
耿	grviou
埂	grvovi
梗	grvvia
耕	grvvvv
尕	gsauiu
伽	gsiauo
钆	gsioaa
尜	gsiuvu
咖	gsoauo
噶	gsoiio
嘎	gsovui
旮	gsuaoi
胳	gsuuao
轧	gsvaaa
夹	gsvouv
尬	gsvuiu
戛	gsvuva
贯	gtaaao
纶	gtaaiu
毌	gtaaiv
灌	gtaiio
观	gtaoia
矜	gtaoio
涫	gtaooa
蒄	gtiioa
莞	gtiioo
鹳	gtiiua
倌	gtiooa
掼	gtiuaa
祼	gtoaia
冠	gtoavv
惯	gtooaa
官	gtooia
爟	gtouii
关	gtouvv
鳏	gtuaia
馆	gtuaoo
盥	gtuiia
罐	gtuvii
筦	gtuvoo
管	gtuvoo
棺	gtvooa
瓘	gtvvii
琯	gtvvoo
给	gwaaiv
绲	gwaaoi
滚	gwaovu
衮	gwovuo
鲧	gwuaua
辊	gwvaoi
棍	gwvoiv
磙	gwvuov
洸	gxaiou
潢	gxavii
光	gxioua
咣	gxoiou
广	gxovuu
逛	gxuaoa
犷	gxuaov
胱	gxuiou
𨐈	gxvaio
桄	gxviou
垙	gxvoio
珖	gxvvio
弓	gyavaa
蚣	gyiauo
拱	gyiuvi
供	gyivii
宫	gyoooo
唝	gyoviv
觥	gyuaio
躬	gyuiav
公	gyuoao
肱	gyuvua
汞	gyviaa
䢼	gyviai
贡	gyviao
功	gyviau
恭	gyviiu
巩	gyviua
共	gyviuo
攻	gyviuv
工	gyvivv
廾	gyvuii
龚	gyvuvi
珙	gyvvvi
缟	gzaaov
藁	gziivv
镐	gzioov
锆	gziouv
搞	gziuov
诰	gzoauv
杲	gzoivv
羔	gzouoo
糕	gzouou
高	gzovia
膏	gzovuu
睾	gzuivo
皋	gzuivu
郜	gzuvai
告	gzuvoo
稿	gzuvov
篙	gzuvov
筶	gzuvuv
槁	gzvovo
槔	gzvuia
缋	hbaaia
绘	hbaaiv
洄	hbaiav
隳	hbaiii
堕	hbaivo
浍	hbaivv
翚	hbaooa
贿	hbaovu
汇	hbavaa
翙	hbiaao
蛔	hbiaia
回	hbiaoo
蟪	hbiavi
茴	hbiiia
荟	hbiiiv
蕙	hbiivi
辉	hbiooa
挥	hbiuoa
会	hbivva
喙	hboaav
诲	hboauv
诙	hboavu
袆	hboavv
讳	hboavv
晖	hboioa
晦	hboiuv
悔	hboouv
恢	hboovu
烩	hbouiv
烠	hbouvu
咴	hbovuo
麾	hbovuv
毁	hbuiua
卉	hbuovu
徽	hbuuia
秽	hbuvia
惠	hbvioa
桧	hbvivv
恚	hbvooa
虺	hbvuia
灰	hbvuou
彗	hbvvav
橞	hbvvia
慧	hbvvoa
珲	hbvvoa
骺	hdiauu
侯	hdiavu
候	hdiiav
吼	hdoaiv
喉	hdoiav
鲎	hdooua
糇	hdouia
吽	hdouvv
瘊	hdovia
猴	hduaia
鲘	hduauu
齁	hduiua
後	hduuaa
郈	hduuai
逅	hduuoa
后	hduuoo
垕	hduuvo
篌	hduvia
堠	hdvoia
厚	hdvuoi
纥	heaauv
涸	heaiav
渴	heaoiu
翯	heaoov
贺	heauao
河	heavoi
菏	heiiav
荷	heiiiv
郃	heivai
盒	heivia
何	heivoi
合	heivoo
龁	heivuv
龢	heivuv
壑	heivvo
颌	heivvu
褐	heoaoi
鹤	heoaua
诃	heoavo
嗬	heoiii
阂	heoiov
曷	heoiua
鹖	heoiua
阖	heoivo
喝	heooiu
熇	heouov
劾	heovau
吓	heovio
呵	heovoi
饸	heuaiv
貉	heuoua
盉	heuvia
禾	heuviu
和	heuvoo
鞨	hevioi
翮	hevoao
盍	hevoia
垎	hevoua
核	hevova
赫	hevovo
涵	hfaaio
汉	hfaaoo
函	hfaiai
浛	hfaioa
瀚	hfauoo
憨	hfavoa
汗	hfavvi
崡	hfiaai
蚶	hfiavi
嵅	hfiavu
虷	hfiavv
菡	hfiiai
蔊	hfiiou
含	hfiooo
颔	hfiovu
撖	hfiuav
捍	hfiuoi
撼	hfiuvu
扞	hfiuvv
罕	hfoavv
阚	hfoiav
晗	hfoiio
暵	hfoivi
旱	hfoivv
㘎	hfooia
悍	hfoooi
寒	hfoooo
憾	hfoovu
焓	hfouio
焊	hfouoi
喊	hfovuv
犴	hfuavv
鼾	hfuivv
翰	hfuoia
韩	hfuovv
邯	hfviai
酣	hfvivi
垾	hfvooi
邗	hfvvai
琀	hfvvio
顸	hfvvvu
淮	hgaiov
踝	hgoiia
怀	hgoovu
徊	hguuia
坏	hgvovu
槐	hgvuia
骇	hhaaov
孩	hhaiov
海	hhauva
骸	hhiaov
咍	hhoaoo
嗨	hhoauv
嗐	hhoooa
咳	hhoova
害	hhoovv
亥	hhovau
胲	hhuova
氦	hhuvov
醢	hhvivu
还	hhvuoa
滹	hjaiva
浒	hjaoau
沪	hjaoav
淴	hjauau
嫭	hjauiv
湖	hjauoo
弧	hjavuu
囫	hjiaua
鹘	hjiaua
岵	hjiauo
蝴	hjiauo
芴	hjiiua
葫	hjiiuo
护	hjiuoa
虎	hjivua
虍	hjivva
扈	hjoaoa
戽	hjoaoo
隺	hjoaui
祜	hjoauo
许	hjoauv
户	hjoavu
昈	hjoioa
昒	hjoiua
唬	hjoiva
惚	hjooua
怙	hjoouo
唿	hjouau
呼	hjouou
烀	hjouuo
煳	hjouuo
糊	hjouuo
冱	hjovva
鳠	hjuaii
鹱	hjuaii
忽	hjuaoa
斛	hjuaoo
猢	hjuauo
狐	hjuauu
鹕	hjuoua
胡	hjuouu
乎	hjuouv
和	hjuvoo
笏	hjuvua
鹄	hjuvua
互	hjvaav
轷	hjvauo
醐	hjviuo
鄠	hjvoai
壶	hjvoii
縠	hjvoua
觳	hjvoua
核	hjvova
槲	hjvuau
瓠	hjvuuu
琥	hjvviv
瑚	hjvvuo
濩	hlaiii
漷	hlaovo
活	hlauvi
彟	hlavii
蠖	hliaii
夥	hliaua
劐	hliiii
获	hliiua
藿	hliivo
镬	hlioii
钬	hlioou
锪	hlioua
伙	hlioui
货	hliuao
佸	hliuvi
攉	hliuvo
祸	hloaoi
嚄	hloiii
豁	hloouo
火	hlouii
㸌	hlouvo
嚯	hlovoa
和	hluvoo
霍	hlvoio
惑	hlvooa
或	hlvova
耠	hlvviv
隍	hmaiui
滉	hmaoii
湟	hmauia
媓	hmauui
潢	hmavii
幌	hmiaoi
蝗	hmiaui
蟥	hmiavi
荒	hmiiov
𨱑	hmioii
锽	hmioui
谎	hmoaii
晃	hmoiio
慌	hmooii
恍	hmooio
惶	hmooui
喤	hmouia
煌	hmouui
肓	hmovuu
癀	hmovvi
凰	hmuaui
鳇	hmuaui
㿠	hmuiio
遑	hmuioa
皇	hmuivv
徨	hmuuui
艎	hmuuui
篁	hmuvui
簧	hmuvvi
黄	hmviia
磺	hmvuvi
瑝	hmvvui
璜	hmvvvi
哏	hnoavv
恨	hnooav
痕	hnovav
狠	hnuaav
很	hnuuav
绗	hpaauu
沆	hpaovu
吭	hpoovu
颃	hpovvu
航	hpuuov
行	hpuuvv
巷	hpviav
杭	hpvovu
夯	hpvuau
桁	hpvuui
珩	hpvvuu
骅	hqaaiu
滑	hqaiaa
婳	hqauvi
花	hqiiiu
铧	hqioiu
化	hqiuaa
华	hqiuuo
话	hqoauv
哗	hqoiua
猾	hquaia
觟	hquavo
划	hqvaii
画	hqviav
桦	hqviua
砉	hqvvvu
姮	hrauvo
蘅	hriiuu
哼	hroovo
恒	hroovo
亨	hrovoa
衡	hruuua
鸻	hruuua
桁	hrvuui
横	hrvvii
珩	hrvvuu
蛤	hsiaiv
虾	hsiavi
铪	hsioiv
哈	hsoivo
呵	hsovoi
幻	htaaaa
缳	htaaia
缓	htaauo
澴	htaiai
漶	htaiav
浣	htaooa
欢	htaoua
涣	htauai
嬛	htauia
洹	htavoi
圜	htiaia
患	htiaoa
鹮	htiaua
峘	htiavo
萑	htiiio
荁	htiivo
镮	htioia
锾	htiouo
擐	htiuia
换	htiuua
㬊	htoiuo
寰	htooia
逭	htoooa
宦	htoovi
唤	htouai
焕	htouua
豢	htouvu
痪	htovua
郇	htuaai
奂	htuaia
獾	htuaii
鲩	htuaoo
貆	htuovo
鬟	htviia
垸	htvooo
还	htvuoa
桓	htvvoi
𤩽	htvvuo
环	htvvvu
溷	hwaiav
浑	hwaoav
混	hwaoiv
婫	hwauoi
婚	hwauua
黑	hwiaoo
荤	hwiiva
诨	hwoaoa
嗨	hwoauv
嘿	hwoiao
阍	hwoiua
惛	hwooua
昏	hwuaoi
馄	hwuaoi
珲	hwvvoa
魂	hwvvui
隍	hxaiui
滉	hxaoii
湟	hxauia
媓	hxauui
潢	hxavii
幌	hxiaoi
蝗	hxiaui
蟥	hxiavi
荒	hxiiov
𨱑	hxioii
锽	hxioui
谎	hxoaii
晃	hxoiio
慌	hxooii
恍	hxooio
惶	hxooui
喤	hxouia
煌	hxouui
肓	hxovuu
癀	hxovvi
凰	hxuaui
鳇	hxuaui
㿠	hxuiio
遑	hxuioa
皇	hxuivv
徨	hxuuui
艎	hxuuui
篁	hxuvui
簧	hxuvvi
黄	hxviia
磺	hxvuvi
瑝	hxvvui
璜	hxvvvi
泓	hyaava
红	hyaavi
纮	hyaavu
弘	hyavao
洪	hyavii
鸿	hyavua
虹	hyiavi
荭	hyiiaa
蕻	hyiivi
薨	hyiivu
讧	hyoavi
闳	hyoivu
黉	hyoovi
宏	hyoovu
烘	hyouvi
吽	hyouvv
哄	hyovii
竑	hyovvu
訇	hyuaov
谼	hyuovi
轰	hyvaao
翃	hyvuao
硔	hyvuvi
玒	hyvvvi
灏	hzaoio
淏	hzaoiv
濠	hzaovo
好	hzauai
浩	hzauvi
蚝	hziauv
薅	hziiau
蒿	hziiov
镐	hzioov
侴	hzivav
嚆	hzoiio
颢	hzoivu
昊	hzoivv
嚎	hzoovo
嗥	hzouia
号	hzovaa
鄗	hzovai
毫	hzovuv
豪	hzovvu
皞	hzuiui
皓	hzuiuv
貉	hzuoua
郝	hzvoai
壕	hzvoov
耗	hzvvuv
缙	jbaavi
浕	jbaavu
津	jbaavv
浸	jbaavv
卺	jbaiaa
劲	jbaoau
赆	jbaoav
矜	jbaoio
妗	jbauio
溍	jbavii
尽	jbavoo
巾	jbiaii
仅	jbiaoo
紧	jbiiaa
荩	jbiiav
今	jbioaa
金	jbioo
锦	jbioui
祲	jboaav
衿	jboaio
谨	jboavi
襟	jboavv
烬	jbouav
廑	jbovvi
噤	jbovvv
馑	jbuavi
近	jbuuoa
斤	jbuuvi
筋	jbuvua
堇	jbviia
觐	jbviia
晋	jbvioi
靳	jbviuu
墐	jbvovi
殣	jbvuvi
珒	jbvvav
槿	jbvvii
进	jbvvoa
瑨	jbvvvi
瑾	jbvvvi
琎	jbvvvu
禁	jbvvvv
剿	jcaaii
糸	jcaaiu
绞	jcaaov
缴	jcaaui
骄	jcaauv
滘	jcaoau
姣	jcauov
漖	jcauov
娇	jcauuv
湫	jcauvi
浇	jcavau
峧	jciaov
蛟	jciaov
峤	jciauv
蕉	jciiio
藠	jciioi
斠	jciioo
僬	jciiov
茭	jciiov
艽	jciiua
焦	jciooo
铰	jcioov
鹪	jcioua
佼	jciovu
搅	jciuoo
挢	jciuuv
侥	jcivau
叫	jcoaii
噍	jcoiov
跤	jcoiov
觉	jcooia
窖	jcoouv
燋	jcouio
嚼	jcouoo
郊	jcovai
䴔	jcovua
交	jcovuo
狡	jcuaov
饺	jcuaov
鲛	jcuaov
角	jcuaua
皎	jcuiov
皦	jcuiui
皭	jcuiuo
敫	jcuiuv
教	jcuouv
胶	jcuovu
徼	jcuuui
脚	jcuvoa
矫	jcuvuv
较	jcvaov
轿	jcvauv
醮	jcviio
酵	jcviuo
椒	jcvivv
校	jcvovu
礁	jcvuio
璬	jcvvui
结	jdaavo
岊	jdaiia
阶	jdaiiu
孑	jdaivv
姐	jdauia
婕	jdauva
湝	jdavau
届	jdavia
洁	jdavoo
界	jdiaiu
蚧	jdiaiu
骱	jdiaiu
睫	jdiava
蜐	jdiavo
节	jdiiai
芥	jdiiiu
价	jdiiui
藉	jdiivv
偈	jdioiu
介	jdiuii
揭	jdiuoi
接	jdiuov
捷	jdiuva
拮	jdiuvo
借	jdivii
褯	jdoaov
诘	jdoavo
讦	jdoavv
诫	jdoavv
嗟	jdoouv
悈	jdoovv
羯	jdouoi
疖	jdovai
喈	jdovau
疥	jdoviu
竭	jdovoi
解	jduaau
鲒	jduavo
桀	jduavv
劼	jduoau
截	jduoio
街	jduuvo
秸	jduvvo
皆	jdvaui
劫	jdvoau
杰	jdvooo
颉	jdvovu
檞	jdvuau
碣	jdvuoi
㛃	jdvvau
楷	jdvvau
玠	jdvviu
桔	jdvvoo
戒	jdvvui
澈	jeaova
扯	jeiuiv
撤	jeiuov
㬚	jeoiov
彻	jeuuva
掣	jeuviu
车	jevavi
坼	jevouu
砗	jevuva
骣	jfaaav
缠	jfaaov
潺	jfaavu
澶	jfaovi
浐	jfaovo
瀍	jfaovu
婵	jfauou
孱	jfavai
羼	jfavou
辿	jfiaoa
蝉	jfiaou
巉	jfiaua
蟾	jfiaua
蒇	jfiivu
儳	jfioai
铲	jfioov
镵	jfioua
镡	jfiovi
掺	jfiuao
搀	jfiuua
觇	jfivia
禅	jfoaou
襜	jfoaua
谄	jfoaua
谗	jfoaua
旵	jfoiia
阐	jfoiou
躔	jfoiov
忏	jfoouv
冁	jfouav
单	jfouia
廛	jfovia
产	jfovou
颤	jfovvu
馋	jfuaua
韂	jfviua
梴	jfvuiv
刬	jfvvii
经	jgaaao
泾	jgaaov
阱	jgaivv
劲	jgaoau
刭	jgaoii
迳	jgaooa
颈	jgaovu
婧	jgauvv
弪	jgavao
汫	jgavvu
睛	jgiavv
茎	jgiiao
荆	jgiiii
儆	jgiiiu
警	jgiiov
敬	jgiiuv
菁	jgiivv
镜	jgioov
晶	jgoioi
景	jgoiov
憬	jgoooi
惊	jgooov
粳	jgouvi
精	jgouvv
痉	jgovao
京	jgoviu
竞	jgovou
麖	jgovov
净	jgovua
竟	jgovua
竫	jgovua
旌	jgovuv
靖	jgovvv
猄	jguaov
獍	jguaov
胫	jguaov
鲸	jguaov
鼱	jguivv
兢	jguo
𠳬	jguouo
径	jguuao
腈	jguvvi
肼	jguvvu
箐	jguvvv
境	jgvoov
靓	jgvvia
璥	jgvvii
璟	jgvvoi
䴖	jgvvua
静	jgvvua
井	jgvvui
绝	jhaaua
孓	jhaioo
㵐	jhavuo
𨟠	jhiaai
崛	jhiaav
矍	jhiaio
倔	jhiavu
茝	jhiivi
蕨	jhiivu
鐍	jhioao
钗	jhioao
傕	jhioau
侪	jhiovu
镢	jhiovu
抉	jhiuav
掘	jhiuav
攫	jhiuia
拆	jhiuuu
撅	jhiuvu
柴	jhivvv
谲	jhoaao
诀	jhoaav
噱	jhoiva
蹶	jhoivu
觉	jhooia
嚼	jhouoo
爝	jhouuo
差	jhouvi
决	jhovav
瘥	jhovou
噘	jhovuo
觖	jhuaav
玃	jhuaia
角	jhuaua
獗	jhuavu
鳜	jhuavu
爵	jhuoav
豺	jhuovi
虿	jhvaia
桷	jhvuau
砄	jhvuav
劂	jhvuii
厥	jhvuou
玦	jhvvav
橛	jhvvuo
珏	jhvvvv
绌	jjaaai
滁	jjaaii
䢺	jjaiai
出	jjaiia
除	jjaiiv
濋	jjavva
黜	jjiaai
蜍	jjiaiv
俶	jjiivv
储	jjioau
锄	jjioia
搐	jjiuov
摴	jjiuvo
初	jjoaau
褚	jjoauo
躇	jjoiii
蹰	jjoivu
㤘	jjooua
怵	jjoovo
憷	jjoovv
畜	jjovia
刍	jjuaav
触	jjuaia
处	jjuaio
雏	jjuaio
矗	jjuouo
䝙	jjuovu
斶	jjuuia
础	jjvuai
楮	jjvuov
厨	jjvuvo
杵	jjvuvu
楚	jjvvai
亍	jjvvii
樗	jjvvoa
橱	jjvvuv
纪	jkaaav
畿	jkaaia
给	jkaaiv
骥	jkaaiv
继	jkaaou
缉	jkaaov
级	jkaaua
绩	jkaavv
瀱	jkaiai
亟	jkaiia
际	jkaivv
鸡	jkaoua
济	jkaovu
汲	jkauao
漈	jkauao
洎	jkauia
激	jkauia
嫉	jkauov
妓	jkauuo
姞	jkauuo
姬	jkauvi
己	jkavaa
即	jkavai
忌	jkavoa
暨	jkavoi
屐	jkavuu
既	jkavva
堲	jkavvo
彐	jkavvv
觊	jkiaia
嵴	jkiaov
岌	jkiaua
虮	jkiaua
羁	jkiavi
畸	jkiavu
罽	jkiavu
荠	jkiiov
蒺	jkiiov
蕺	jkiiov
芨	jkiiua
蓟	jkiiua
芰	jkiiuo
䓫	jkiivu
藉	jkiivv
偈	jkioiu
集	jkiovv
伋	jkiuao
伎	jkiuoa
挤	jkiuov
技	jkiuuo
掎	jkiuvu
乩	jkivaa
冀	jkivia
佶	jkivoo
记	jkoaav
讥	jkoaua
计	jkoauo
诘	jkoavo
唧	jkoavv
跽	jkoiav
跻	jkoiov
蹐	jkoiuo
寂	jkooiv
悸	jkoouv
哜	jkoovu
寄	jkoovu
叽	jkouaa
剂	jkovii
戢	jkovii
齑	jkoviv
迹	jkovoa
咭	jkovoo
瘠	jkovov
麂	jkovua
脊	jkovuu
疾	jkovuv
几	jkuaaa
鱾	jkuaav
鲫	jkuaav
系	jkuaiu
急	jkuaoa
及	jkuaoo
鲚	jkuaov
饥	jkuaua
觭	jkuavu
祭	jkuavv
赍	jkuoao
鹡	jkuoua
戟	jkuova
肌	jkuuaa
徛	jkuuvu
季	jkuvai
稷	jkuvia
积	jkuvou
穄	jkuvua
笈	jkuvua
箕	jkuvvi
嵇	jkuvvu
犄	jkuvvu
稽	jkuvvu
笄	jkuvvv
籍	jkuvvv
辑	jkvaov
惎	jkvioa
期	jkviu
其	jkviuo
棘	jkvivi
基	jkvivo
墼	jkvivo
髻	jkvivo
吉	jkvooo
霁	jkvoov
圾	jkvoua
垍	jkvoui
楫	jkvovi
机	jkvuaa
殛	jkvuai
极	jkvuao
丌	jkvuii
剞	jkvuii
矶	jkvuua
奇	jkvuvo
击	jkvvia
玑	jkvvua
耤	jkvvvi
枅	jkvvvu
驹	jlaaua
沮	jlaiav
澽	jlaiva
泃	jlauao
娵	jlauvi
局	jlavao
剧	jlavii
居	jlavuo
屦	jlavuu
崌	jliaav
岨	jliaia
瞿	jliaio
雎	jliaio
䴗	jliaua
具	jliauo
岠	jliava
倨	jliavu
且	jliavv
俱	jliiav
苴	jliiia
莒	jliioo
蒟	jliiov
菊	jliiua
苣	jliiva
锔	jlioav
锯	jlioav
钜	jliova
据	jliuav
拘	jliuua
掬	jliuua
拒	jliuva
龃	jlivia
遽	jlivoa
裾	jloaav
讵	jloava
咀	jloiav
踞	jloiav
踽	jloiui
距	jloiva
惧	jlooia
窭	jlooou
举	jloovv
焗	jlouav
炬	jlouva
疽	jlovia
狙	jluaia
飓	jluaia
句	jluaoo
腒	jluavu
犋	jluvia
筥	jluvoo
矩	jluvva
秬	jluvva
榘	jluvvv
橘	jlvaoa
巨	jlvava
车	jlvavi
椐	jlvavu
醵	jlviiv
鞠	jlviua
鞫	jlviua
聚	jlviui
趄	jlvoia
榉	jlvoou
弆	jlvovu
枸	jlvuao
砠	jlvuia
柜	jlvvav
琚	jlvvav
桔	jlvvoo
缣	jmaaou
溅	jmaaov
缄	jmaavu
艰	jmaoav
涧	jmaoia
湔	jmaouv
贱	jmaovv
奸	jmauvv
渐	jmavai
建	jmavao
囝	jmiaai
睑	jmiaiv
见	jmiaua
健	jmiavv
监	jmiiia
茧	jmiiia
鉴	jmiiio
菅	jmiioo
蒹	jmiiou
俭	jmiivo
坚	jmiivo
荐	jmiivu
键	jmioav
锏	jmiooi
捡	jmiuiv
搛	jmiuou
拣	jmiuva
尖	jmiuvu
件	jmiuvv
僭	jmivau
剑	jmivii
牮	jmivuv
裥	jmoaoi
谫	jmoaou
肩	jmoauu
谏	jmoavi
踺	jmoiav
间	jmoioi
暕	jmoivi
趼	jmoivv
践	jmoivv
蹇	jmoooi
謇	jmooov
翦	jmouao
剪	jmouau
煎	jmouoo
鹣	jmouua
兼	jmouva
减	jmovvu
鲣	jmuaii
鳒	jmuaou
腱	jmuavv
饯	jmuavv
舰	jmuuia
毽	jmuvav
犍	jmuvav
笕	jmuvia
篯	jmuvio
简	jmuvoi
箭	jmuvou
笺	jmuvvv
楗	jmvavv
靬	jmvavv
柬	jmviao
枧	jmviau
鞬	jmviav
鞯	jmviii
槛	jmviiu
戬	jmviva
检	jmvivo
硷	jmvuiv
歼	jmvuuv
碱	jmvuvu
戋	jmvvau
陈	jnaiva
沉	jnaoau
瞋	jniauo
伧	jniiaa
抻	jniuia
尘	jniuvo
龀	jnivua
谶	jnoaii
衬	jnoavi
谌	jnoavi
晨	jnoivu
忱	jnoooa
宸	jnoovu
嗔	jnouoi
煁	jnouvi
疢	jnovou
称	jnuvua
梣	jnviai
臣	jnviav
趁	jnvoiu
榇	jnvovo
碜	jnvuao
辰	jnvuvv
郴	jnvvai
棽	jnvvio
琛	jnvvoa
淌	jpaiou
嫦	jpauio
娼	jpauoi
畅	jpiaau
菖	jpiioi
偿	jpiiou
苌	jpiiuv
常	jpioia
倡	jpioio
裳	jpioov
敞	jpiouv
氅	jpiouv
尝	jpiovv
伥	jpiuva
昶	jpoaoi
昌	jpoioi
阊	jpoioi
唱	jpooio
惝	jpooio
怅	jpoouv
鲿	jpuaio
猖	jpuaoi
鲳	jpuaoi
肠	jpuauu
鬯	jpuoua
徜	jpuuio
长	jpuvao
场	jpvoau
厂	jpvuu
玚	jpvvau
纠	jqaaai
酒	jqavia
㠇	jqiaov
旧	jqioii
僦	jqiovo
揪	jqiuuv
韭	jqivvv
阄	jqoiua
究	jqooua
啾	jqouvi
疚	jqovua
鹫	jqovua
就	jqovvu
九	jquaa
久	jquaoo
咎	jquaoo
灸	jquaou
鸠	jquaua
舅	jquiia
臼	jquiva
救	jqviuv
鬏	jqviuv
赳	jqvoai
厩	jqvuav
桕	jqvuiv
柩	jqvvua
玖	jqvvua
骋	jraaia
澄	jraaou
澂	jraiai
丞	jraiau
承	jraivv
蛏	jriaao
瞠	jriaio
铛	jrioio
牚	jriova
铖	jriovu
抢	jriuia
撑	jriuio
偁	jriuoo
裎	jroaov
诚	jroavu
晟	jroivu
憕	jrooao
宬	jroovu
逞	jrovoa
呈	jrovvi
庱	jrovvo
塍	jruouv
惩	jruuoa
乘	jruviv
程	jruvov
称	jruvua
秤	jruvvo
橙	jrvaou
柽	jrvaov
酲	jrviov
赪	jrvoiv
埕	jrvoov
城	jrvovu
成	jrvuaa
盛	jrvuia
枨	jrvuva
珵	jrvvov
琤	jrvvua
珹	jrvvvu
泇	jsaauo
驾	jsauaa
迦	jsauoa
加	jsauoo
嫁	jsauoo
袈	jsauov
架	jsauvv
叚	jsaviv
浃	jsavou
岬	jsiaia
伽	jsiauo
假	jsiavi
蛱	jsiavo
甲	jsiavv
茄	jsiiau
葭	jsiiav
价	jsiiui
荚	jsiivo
钾	jsioia
镓	jsiooo
铗	jsiovo
拮	jsiuvo
挟	jsiuvo
佳	jsivov
袷	jsoaiv
咖	jsoauo
跏	jsoiau
斝	jsoooo
家	jsoovu
痂	jsovau
瘕	jsovav
胛	jsuiav
笳	jsuvau
稼	jsuvoo
枷	jsvauo
贾	jsviao
郏	jsvoai
嘉	jsvoau
夹	jsvouv
颉	jsvovu
颊	jsvovu
戛	jsvuva
珈	jsvvau
槚	jsvvia
恝	jsvvoa
绢	jtaaou
涓	jtaouu
娟	jtauou
圈	jtiaou
隽	jtioau
镌	jtioio
锩	jtioou
倦	jtiouv
捐	jtiuou
卷	jtouaa
眷	jtouia
蠲	jtouia
焆	jtouou
鹃	jtouua
桊	jtouvv
狷	jtuaou
鄄	jtviai
骏	jwaaao
浚	jwaaou
纯	jwaava
淳	jwaovo
郡	jwavai
君	jwavoo
峻	jwiaao
畯	jwiaao
俊	jwiaou
蝽	jwiavv
莼	jwiiaa
莙	jwiiav
菌	jwiiia
葰	jwiiia
隽	jwioau
钧	jwioua
捃	jwiuav
皲	jwoaau
军	jwoava
晙	jwoiao
竣	jwovao
鹑	jwovua
麇	jwovuv
鲪	jwuaav
龟	jwuaia
䲠	jwuavv
朐	jwuuao
肫	jwuvai
䏝	jwuvva
筠	jwuvvo
醇	jwviov
均	jwvoua
唇	jwvuoo
珺	jwvvav
蠢	jwvvia
春	jwvvoi
椿	jwvvvv
瑃	jwvvvv
绛	jxaaua
缰	jxaavi
降	jxaiua
洚	jxauao
江	jxaviv
强	jxavoi
弶	jxavov
犟	jxavuv
疆	jxavvi
茳	jxiiav
蒋	jxiiov
僵	jxivia
讲	jxoavv
姜	jxouau
糨	jxouav
浆	jxovaa
将	jxovua
酱	jxovvi
奖	jxovvu
桨	jxovvv
鳉	jxuaov
膙	jxuava
豇	jxvovi
匠	jxvuuv
礓	jxvuvi
耩	jxvvvv
䌹	jyaaia
泂	jyaiao
迥	jyiaoa
冏	jyiauo
囧	jyiauo
扃	jyoaia
炅	jyoiou
窘	jyooav
炯	jyouia
颎	jyuavu
䐃	jyuiau
坰	jyvoia
巢	jzaaia
剿	jzaaii
绰	jzaaiv
潮	jzauoo
弨	jzavau
钞	jzioiu
抄	jziuiu
吵	jzoiuo
晁	jzoiuo
怊	jzooau
炒	jzouiu
焯	jzouiv
嘲	jzouoo
朝	jzuouu
超	jzvoau
耖	jzvviu
骙	kbaaao
溃	kbaiav
隗	kbaiui
戣	kbaova
睽	kbiaao
岿	kbiaiu
蝰	kbiavu
葵	kbiiao
蒉	kbiiia
揆	kbiuao
傀	kbiuia
暌	kboiao
喟	kboiav
跬	kboivo
悝	kbooia
愦	kbooia
愧	kbooui
窥	kboovv
夔	kbouui
煃	kbouvu
喹	kbovuo
馈	kbuaia
馗	kbuaou
魁	kbuioo
篑	kbuvia
匮	kbviav
聩	kbviia
逵	kbvooa
櫆	kbvuia
盔	kbvuia
奎	kbvuvo
亏	kbvvaa
眍	kdiavu
芤	kdiiai
蔻	kdiioo
扣	kdiuoo
抠	kdiuvu
叩	kdoaii
口	kdooo
寇	kdoovv
筘	kduviu
骒	keaaia
缂	keaavi
牁	keaivo
渴	keaoiu
溘	keavoa
髁	keiaia
蝌	keiauv
岢	keiavo
瞌	keiavo
蚵	keiavo
颗	keiavu
苛	keiivo
锞	keioia
铪	keioiv
钶	keiovo
课	keoaia
窠	keooia
喀	keoooa
客	keooua
恪	keooua
咳	keoova
炣	keouvo
刻	keovii
嗑	keovoa
呵	keovoi
疴	keovvo
颏	keovvu
克	keuoou
尅	keuovi
稞	keuvia
科	keuvoo
氪	keuvuo
轲	kevavo
棵	keviav
匼	kevivo
可	kevoii
壳	kevoua
坷	kevovo
磕	kevuvo
柯	kevvoi
珂	kevvvo
瞰	kfiaav
嵁	kfiavi
崁	kfiavo
莰	kfiivo
侃	kfioui
看	kfiuia
龛	kfivvu
阚	kfoiav
衎	kfuivv
勘	kfviau
槛	kfviiu
戡	kfviva
坎	kfvoua
堪	kfvovi
墈	kfvovi
砍	kfvuua
磡	kfvuvi
刊	kfvvii
浍	kgaivv
蒉	kgiiia
蒯	kgiiii
侩	kgiivv
㧟	kgiuav
郐	kgivai
会	kgivva
哙	kgoivv
快	kgooav
狯	kguaiv
鲙	kguaiv
脍	kguivv
筷	kguvoo
块	kgvoav
剀	khiaii
凯	khiaua
蒈	khiiva
铠	khioia
锎	khiooi
锴	khiova
揩	khiuva
闿	khoiia
慨	khooav
恺	khooia
忾	khoouv
炌	khouiu
垲	khvoia
楷	khvvau
开	khvvui
绔	kjaavu
圐	kjiaia
骷	kjiauo
苦	kjiiuo
裤	kjoaov
袴	kjoavu
窟	kjooav
喾	kjoouv
哭	kjoovu
库	kjovva
酷	kjviuv
堀	kjvoav
刳	kjvuii
枯	kjvuoo
矻	kjvuuv
蛞	kliauv
扩	kliuov
括	kliuuv
阔	kloiau
廓	klovov
纩	kmaaov
贶	kmaoou
洭	kmavvv
眶	kmiavv
诳	kmoaua
诓	kmoavv
旷	kmoiov
邝	kmovai
况	kmovou
哐	kmovvv
狂	kmuavv
筐	kmuvvv
圹	kmvoov
矿	kmvuov
夼	kmvuui
匡	kmvvvi
框	kmvvvv
恳	knavoa
垦	knavvo
龈	knivav
肯	knivuu
裉	knoaav
啃	knoivi
硍	knvuav
钪	kpioov
伉	kpiovu
抗	kpiuov
扛	kpiuvi
闶	kpoiov
慷	kpooov
炕	kpouov
糠	kpouov
康	kpovav
亢	kpovua
𩾌	kpuaov
𡐓	kpvoov
姱	kqauvu
挎	kqiuvu
侉	kqivuo
跨	kqoivu
胯	kquvuo
垮	kqvovu
夸	kqvuvv
铿	krioii
吭	kroovu
坑	krvoov
硁	krvuao
佧	ksiivv
卡	ksivvi
咖	ksoauo
咔	ksoivv
喀	ksoooa
咯	ksouao
胩	ksuivv
髋	ktiaoo
宽	ktooii
款	ktvoua
困	kwiavv
锟	kwiooi
捆	kwiuia
裈	kwoaoa
阃	kwoiia
鹍	kwoiua
昆	kwoiva
悃	kwooia
焜	kwouoi
堃	kwovvo
鲲	kwuaoi
剋	kwuoii
醌	kwvioi
髡	kwvivu
坤	kwvoia
壸	kwvovi
琨	kwvvoi
纩	kxaaov
贶	kxaoou
洭	kxavvv
眶	kxiavv
诳	kxoaua
诓	kxoavv
旷	kxoiov
邝	kxovai
况	kxovou
哐	kxovvv
狂	kxuavv
筐	kxuvvv
圹	kxvoov
矿	kxvuov
夼	kxvuui
匡	kxvvvi
框	kxvvvv
孔	kyaiaa
崆	kyiaoo
倥	kyiooa
控	kyiuoo
空	kyoovi
箜	kyuvoo
恐	kyvioa
埪	kyvooo
硿	kyvuoo
洘	kzauov
尻	kzavua
铐	kziouo
拷	kziuuo
烤	kzouuo
㸆	kzouuv
考	kzuova
靠	kzuviv
犒	kzuvov
栲	kzvuov
潾	lbaouv
淋	lbavvv
嶙	lbiaou
瞵	lbiaou
蔺	lbiioi
临	lbiiuv
邻	lbioai
赁	lbiuao
拎	lbiuio
躏	lboiii
懔	lbooov
粼	lbouaa
翷	lbouao
遴	lbouoa
燐	lbouou
吝	lbovoo
麟	lbovou
凛	lbovov
廪	lbovov
啉	lbovvv
鳞	lbuaou
膦	lbuouv
箖	lbuvvv
辚	lbvaou
檩	lbvovi
霖	lbvovv
磷	lbvuou
璘	lbvvou
林	lbvvv
琳	lbvvvv
漻	lcaaov
缭	lcaavu
了	lcaii
辽	lcaioa
嫽	lcauvu
潦	lcavuo
髎	lciaao
瞭	lciavu
蓼	lciiao
钌	lcioai
镣	lciovu
撂	lciuia
撩	lciuvu
僚	lcivuo
蹽	lcoivu
寥	lcooao
寮	lcoovu
憭	lcoovu
料	lcouoo
燎	lcouvu
疗	lcovai
廖	lcovao
嘹	lcovuo
獠	lcuavu
簝	lcuvvu
聊	lcviua
尥	lcvuua
鹩	lcvuua
橑	lcvvuo
漏	ldaa
漏	ldaavu
陋	ldaivi
溇	ldaouv
洌	ldavua
䁖	ldiaou
嵝	ldiaou
蝼	ldiaou
髅	ldiaou
蒌	ldiiou
镂	ldioou
偻	ldiouv
劣	ldiuau
捩	ldiuoa
搂	ldiuou
躐	ldoiaa
喽	ldoouv
娄	ldouau
瘘	ldovou
咧	ldovua
冽	ldovvu
猎	lduavi
脟	lduuoo
篓	lduvou
鬣	ldviaa
剅	ldvoii
露	ldvooi
埒	ldvouo
楼	ldvouv
趔	ldvovu
列	ldvuii
烈	ldvuoo
裂	ldvuov
䴕	ldvuua
耧	ldvvou
泐	leaaia
了	leaii
仂	leiauu
叻	leoauu
嘞	leovii
乐	leuaiu
饹	leuaua
肋	leuauu
鳓	leuavi
簕	leuvvi
勒	leviau
砳	levuvu
缆	lfaaii
滥	lfaiiu
澜	lfaoia
漤	lfavva
岚	lfiaua
罱	lfiauo
览	lfiiia
蓝	lfiiii
镧	lfiooi
揽	lfiuii
拦	lfiuou
褴	lfoaii
襕	lfoaoi
谰	lfoaoi
阑	lfoivi
懒	lfoovi
烂	lfouou
兰	lfouvv
斓	lfovoi
啉	lfovvv
篮	lfuvii
榄	lfviiu
栏	lfvouv
婪	lfvvau
绫	lgaavo
泠	lgaioa
陵	lgaivo
姈	lgauio
澪	lgavoa
灵	lgavou
囹	lgiaio
岭	lgiaio
蛉	lgiaio
崚	lgiavo
苓	lgiiio
伶	lgiioa
菱	lgiivo
令	lgioao
翎	lgioao
铃	lgioio
鸰	lgioua
瓴	lgiova
领	lgiovu
龄	lgivio
另	lgoauu
祾	lgoavo
昤	lgoiio
呤	lgoioa
〇	lgoo
㥄	lgoovo
羚	lgouio
凌	lgovvo
鲮	lguavo
舲	lguuio
棂	lgvavv
聆	lgviio
柃	lgvioa
酃	lgvoai
坽	lgvoio
零	lgvoio
玲	lgvvio
棱	lgvvou
濑	lhavia
涞	lhavou
略	lhiaua
圙	lhiauo
崃	lhiavo
睐	lhiavo
莱	lhiivo
锊	lhiouo
铼	lhiovo
掠	lhiuov
俩	lhivia
俫	lhivou
癞	lhovvi
徕	lhuuvo
籁	lhuvvi
赖	lhviua
赉	lhvoao
来	lhvouv
梾	lhvvou
䂮	lhvvvu
绿	ljaaav
渌	ljaavv
泸	ljaiva
陆	ljaivv
勠	ljaoau
潞	ljaoiv
赂	ljaoua
戮	ljaova
漉	ljaovu
澛	ljauai
录	ljavao
逯	ljavoa
僇	ljiaov
蓼	ljiiao
菉	ljiiav
芦	ljiioa
蕗	ljiioi
镥	ljioua
掳	ljiuiv
撸	ljiuua
虏	ljivau
卢	ljivav
卤	ljivia
鸬	ljivua
颅	ljivvu
禄	ljoaav
路	ljoiua
鹭	ljoiua
噜	ljouai
炉	ljouoa
庐	ljovoa
六	ljovuo
鹿	ljovva
鲈	ljuaiv
鲁	ljuaoi
胪	ljuiva
甪	ljuuav
舻	ljuuiv
箓	ljuvav
簏	ljuvov
氇	ljuvua
稑	ljuvvo
轳	ljvaiv
辘	ljvaov
辂	ljvaua
栌	ljviva
垆	ljvoiv
露	ljvooi
橹	ljvuai
碌	ljvuav
琭	ljvvav
璐	ljvvoi
麓	ljvvov
蠡	lkaaia
缡	lkaaov
骊	lkaavi
浬	lkaiav
澧	lkaiav
漓	lkaovu
娌	lkauia
力	lkauu
浰	lkauvi
溧	lkavia
沥	lkavua
隶	lkavvi
罹	lkiaoo
詈	lkiaov
蜊	lkiauv
峛	lkiavu
蛎	lkiavu
里	lkiavv
荔	lkiiau
俚	lkiiav
莅	lkiiio
蓠	lkiiov
莉	lkiiuv
藜	lkiiuv
苈	lkiivu
锂	lkioia
俐	lkiuvi
俪	lkivia
傈	lkivia
例	lkivua
礼	lkoaaa
戾	lkoavu
哩	lkoiav
跞	lkoiua
唳	lkooav
粒	lkouov
粝	lkouvu
离	lkovia
立	lkovou
呖	lkovua
喱	lkovui
痢	lkovuv
疠	lkovva
凓	lkovvi
疬	lkovvu
狸	lkuaia
鲤	lkuaia
鳢	lkuaia
猁	lkuauv
鲡	lkuavi
黎	lkuvia
黧	lkuvia
利	lkuvii
笠	lkuvov
篱	lkuvov
犁	lkuvuv
篥	lkuvvi
梨	lkuvvv
李	lkvaiv
轹	lkvaua
朸	lkvauu
郦	lkviai
丽	lkviao
吏	lkviav
醴	lkviia
逦	lkvioa
醨	lkviov
鹂	lkviua
栗	lkvivv
鬲	lkvoia
坜	lkvovu
雳	lkvovu
栎	lkvuai
励	lkvuau
历	lkvuau
厘	lkvuia
砬	lkvuov
砾	lkvuua
厉	lkvuva
㰀	lkvuvi
砺	lkvuvu
珕	lkvvau
理	lkvvia
璃	lkvvov
枥	lkvvua
嫠	lkvvvu
釐	lkvvvu
绿	llaaav
骡	llaaia
驴	llaaoa
缕	llaaou
络	llaaua
骆	llaaua
漯	llaiav
滤	llaiva
泺	llauai
洛	llauao
屡	llavou
履	llavuu
螺	lliaia
逻	lliaoa
罗	lliaua
落	lliiau
倮	lliiav
萝	lliiia
葎	lliiuu
蓏	lliiuu
荦	lliiuv
锣	llioia
镙	llioia
侣	lliooo
铝	lliooo
偻	lliouv
摞	lliuia
捋	lliuuo
虑	llivoa
裸	lloaia
褛	lloaou
啰	lloiai
闾	lloioo
跞	lloiua
吕	llooo
咯	llouao
烙	llouua
率	llovaa
瘰	llovia
蠃	llovou
膂	llovuu
旅	llovuv
猡	lluaia
雒	lluaio
脶	lluoia
𦝼	lluouv
律	lluuav
氯	lluvav
箩	lluvia
稆	lluvoo
椤	llviai
垏	llvoav
榈	llvoia
梠	llvooo
硌	llvuua
珞	llvvua
练	lmaava
潋	lmaivo
濂	lmaovu
涟	lmavav
蠊	lmiaov
莶	lmiiiv
蔹	lmiiiv
莲	lmiiva
镰	lmioov
链	lmiova
敛	lmivuv
裣	lmoaiv
裢	lmoava
帘	lmooia
怜	lmooio
炼	lmouva
恋	lmovoa
廉	lmovou
鲢	lmuava
脸	lmuivo
臁	lmuovu
连	lmvaoa
联	lmviou
殓	lmvuiv
磏	lmvuou
奁	lmvuvu
梿	lmvvav
楝	lmvvia
琏	lmvvva
瑓	lmvvvi
浪	lpaoav
崀	lpiaoa
螂	lpiaoa
蒗	lpiiao
莨	lpiioa
蓢	lpiioa
锒	lpiooa
郎	lpoaai
朗	lpoauu
塱	lpoavo
㮾	lpoavv
㫰	lpoioa
阆	lpoioa
啷	lpooav
烺	lpouoa
廊	lpovoa
狼	lpuaoa
稂	lpuvoa
筤	lpuvoa
桹	lpvoav
榔	lpvoav
埌	lpvooa
琅	lpvvoa
绺	lqaaua
骝	lqaaua
陆	lqaivv
鎏	lqaoio
鹨	lqaoua
流	lqaova
浏	lqaovu
瑬	lqaovv
溜	lqauao
疁	lqiaao
罶	lqiaua
镠	lqioao
锍	lqioov
镏	lqioua
熘	lqouua
刘	lqovii
瘤	lqovua
六	lqovuo
旒	lqovuv
留	lquaia
遛	lquaoa
飗	lquaua
馏	lquaua
鹠	lquaua
榴	lqvuao
柳	lqvuau
硫	lqvuov
琉	lqvvov
珋	lqvvua
愣	lrooia
冷	lrovio
楞	lrviai
塄	lrvoia
堎	lrvovo
棱	lrvvou
邋	lsaaoa
蜡	lsiavi
蝲	lsiavi
落	lsiiau
镴	lsioaa
拉	lsiuov
俩	lsivia
旯	lsoiua
啦	lsoiuo
喇	lsovia
瘌	lsovvi
辣	lsovvi
腊	lsuvii
剌	lsviii
鞡	lsviiu
垃	lsvoov
砬	lsvuov
滦	ltaovi
孪	ltovai
娈	ltovau
峦	ltovia
脔	ltovia
銮	ltovio
挛	ltoviu
鸾	ltovua
栾	ltovvv
卵	ltuaai
乱	ltuvaa
缧	lwaaia
纶	lwaaiu
泪	lwaiav
漯	lwaiav
沦	lwaiua
垒	lwaovo
嫘	lwauia
累	lwiaaa
囵	lwiaiu
罍	lwiauv
儡	lwiiav
藟	lwiiia
伦	lwiiua
蕾	lwiivo
镭	lwiovo
仑	lwiuaa
抡	lwiuiu
擂	lwiuvo
论	lwoaiu
诔	lwoavv
类	lwouvu
嘞	lwovii
羸	lwovou
癗	lwovvo
肋	lwuauu
轮	lwvaiu
勒	lwviau
酹	lwviuo
雷	lwvoia
礌	lwvuvo
磊	lwvuvu
檑	lwvvoa
耒	lwvvvi
粱	lxaaou
梁	lxaavv
莨	lxiioa
俍	lxioav
倞	lxiovo
俩	lxivia
谅	lxoaov
良	lxoavv
量	lxoiia
踉	lxoioa
晾	lxoiov
悢	lxoooa
粮	lxouoa
凉	lxovov
亮	lxovua
魉	lxuivi
辌	lxvaov
辆	lxvavi
两	lxviau
墚	lxvoaa
椋	lxvovo
靓	lxvvia
漋	lyaaiu
隆	lyaiua
陇	lyaivu
泷	lyavua
眬	lyiavu
茏	lyiivu
拢	lyiuvu
昽	lyoivu
窿	lyooai
癃	lyovai
咙	lyovua
哢	lyovvi
胧	lyuvua
笼	lyuvvu
垅	lyvovu
尨	lyvuau
龙	lyvuau
聋	lyvuvi
垄	lyvuvo
砻	lyvuvu
栊	lyvvua
弄	lyvvvu
珑	lyvvvu
络	lzaaua
涝	lzaiio
嫪	lzauao
姥	lzauuo
潦	lzavuo
崂	lziaii
劳	lziiau
落	lziiau
荖	lziiuo
铹	lzioii
铑	lziouo
捞	lziuii
佬	lziuov
唠	lzoiio
牢	lzoouv
烙	lzouua
痨	lzovii
老	lzuoua
醪	lzviao
酪	lzviua
栳	lzvuov
耢	lzvvii
缗	mbaaav
泯	mbaava
湣	mbaava
民	mbavav
愍	mbavoa
岷	mbiaav
皿	mbiaii
苠	mbiiav
抿	mbiuav
黾	mboiav
闽	mboiia
旻	mboiov
闵	mboiov
悯	mboooi
忞	mbovoa
慜	mbuvoa
鳘	mbuvua
敏	mbuvuv
碈	mbvuua
珉	mbvvav
玟	mbvvov
淼	mcaaaa
缪	mcaaao
缈	mcaaia
渺	mcaiav
妙	mcauiu
瞄	mciaii
眇	mciaiu
苗	mciiia
鹋	mciiua
藐	mciiuo
描	mciuii
喵	mcoiii
庙	mcovia
邈	mcuooa
秒	mcuviu
杪	mcviuo
乜	mdaaa
鍪	mdaoio
牟	mdaouv
眸	mdiaao
蛑	mdiaao
蠛	mdiaii
侔	mdiaou
蔑	mdiiia
哞	mdoaou
谋	mdoavi
咩	mdoouv
篾	mduvia
某	mdvivv
灭	mdvoui
麽	meovua
么	meuaoo
缦	mfaaoi
满	mfaiiv
漫	mfaoii
嫚	mfauoi
瞒	mfiaii
螨	mfiaii
幔	mfiaoi
蔓	mfiioi
颟	mfiivu
镘	mfiooi
谩	mfoaoi
曼	mfoiia
慢	mfoooi
熳	mfouoi
蛮	mfovia
馒	mfuaoi
鳗	mfuaoi
鬘	mfvioi
鞔	mfviua
埋	mfvoia
墁	mfvooi
溟	mgaoao
洺	mgauao
瞑	mgiaoa
螟	mgiaoa
蓂	mgiioa
茗	mgiiua
铭	mgioua
命	mgivoa
冥	mgoaoi
暝	mgoioa
明	mgoiuu
鸣	mgouao
名	mguaoo
酩	mgviua
买	mhaoov
荬	mhiiao
唛	mhovvi
脉	mhuoaa
卖	mhuoao
劢	mhvaau
迈	mhvaoa
埋	mhvoia
霾	mhvouo
麦	mhvvua
母	mjaaov
牟	mjaouv
姆	mjauaa
姥	mjauuo
沐	mjavv
睦	mjiavo
目	mjiavv
募	mjiiau
幕	mjiiia
苜	mjiiia
慕	mjiiiu
暮	mjiioi
墓	mjiivo
钼	mjioia
拇	mjiuaa
仫	mjiuao
呣	mjoaao
𧿹	mjoiaa
亩	mjovia
毪	mjuvao
穆	mjuvui
牧	mjuvuv
牡	mjuvvo
模	mjviio
坶	mjvoaa
木	mjvv
糸	mkaaiu
泌	mkaoao
汨	mkaoii
洣	mkaouv
弥	mkavua
弭	mkavvi
眯	mkiaou
蘼	mkiiov
芈	mkivvv
幂	mkoaia
祕	mkoaoa
谧	mkoaoa
谜	mkoaou
祢	mkoaua
密	mkooia
蜜	mkooia
嘧	mkoooa
宓	mkoooa
咪	mkoouv
迷	mkouoa
敉	mkouuv
米	mkouvv
縻	mkovaa
靡	mkoviv
糜	mkovou
麋	mkovou
猕	mkuaav
觅	mkuoia
脒	mkuouv
秘	mkuvoa
醚	mkviou
醾	mkviov
漠	mlaiio
陌	mlaivu
没	mlauaa
嫫	mlauii
嬷	mlauov
沫	mlavvi
冒	mliaia
墨	mliavo
默	mliavu
蓦	mliiaa
摹	mliiiu
莫	mliioi
藦	mliiov
蘑	mliiov
茉	mliivv
镆	mlioii
摸	mliuii
抹	mliuvv
谟	mloaii
嗼	mloiio
寞	mlooii
瘼	mlovii
摩	mloviu
麽	mlovua
魔	mlovui
磨	mlovvu
馍	mluaii
么	mluaoo
膜	mluiio
脉	mluoaa
貘	mluoii
貉	mluoua
貊	mluovu
秣	mluvvv
万	mlvauu
模	mlviio
靺	mlvivv
殁	mlvuua
末	mlvviu
耱	mlvvov
无	mlvvua
绵	mmaaui
缅	mmaavu
渑	mmaoia
娩	mmauua
沔	mmavia
湎	mmavui
眠	mmiaav
冕	mmiaua
眄	mmiavi
偭	mmivui
黾	mmoiav
愐	mmoovu
勉	mmuaau
免	mmuaia
𩾃	mmuaua
腼	mmuvui
丏	mmviaa
勔	mmvuau
棉	mmvuia
面	mmvuia
懑	mnaioa
汶	mnaovu
们	mnioia
钔	mniooi
扪	mniuoi
门	mnoiaa
闷	mnoioa
焖	mnouoi
鞔	mnviua
漭	mpaiiv
蟒	mpiaii
茫	mpiiao
芒	mpiiov
莽	mpiivu
忙	mpooov
邙	mpovai
氓	mpovav
盲	mpovia
牤	mpuvov
牻	mpuvvu
杧	mpvova
硭	mpvuii
厖	mpvuvu
缪	mqaaao
谬	mqoaao
勐	mraiau
孟	mraiia
濛	mraiio
蜢	mriaai
㠓	mriaii
幪	mriaii
蟒	mriaii
蠓	mriaii
虻	mriaov
瞢	mriiia
萌	mriioi
鹲	mriiua
甍	mriiva
蒙	mriivv
锰	mrioai
黾	mroiav
盟	mroiia
懵	mrooii
氓	mrovav
猛	mruaai
獴	mruaii
朦	mruiio
艋	mruuai
艨	mruuii
檬	mrviio
礞	mrvuii
梦	mrvvua
马	msaavv
妈	msauaa
蚂	msiaaa
蟆	msiaii
抹	msiuvv
祃	msoaaa
吗	msoaav
骂	msooaa
嘛	msoovu
摩	msoviu
麻	msovvv
犸	msuaaa
杩	msvaav
码	msvuaa
玛	msvvaa
湄	mwaaiv
郿	mwaiai
眉	mwaiia
鹛	mwaiua
渼	mwaouv
没	mwauaa
媚	mwauai
浼	mwauai
媄	mwauou
媒	mwauvi
妹	mwauvv
嵋	mwiaai
莓	mwiiuv
镅	mwioai
镁	mwioou
袂	mwoaav
昧	mwoivv
寐	mwooai
煤	mwouvi
美	mwouvu
糜	mwovou
猸	mwuaai
魅	mwuivv
每	mwuvaa
楣	mwvaiv
酶	mwviuv
霉	mwvouv
梅	mwvuva
枚	mwvuvu
瑂	mwvvai
玫	mwvvuv
矛	mzaoai
瞀	mzaoia
蝥	mzaoia
蟊	mzaoia
泖	mzauau
冒	mziaia
帽	mziaia
峁	mziaua
眊	mziauv
鄚	mziiai
茅	mziiao
茆	mziiua
芼	mziiuv
茂	mziivu
锚	mzioii
铆	mzioua
昴	mzoiua
袤	mzovao
旄	mzovuv
卯	mzuaai
贸	mzuaao
猫	mzuaii
貌	mzuoui
耄	mzuouv
牦	mzuvuv
毛	mzuvva
懋	mzvaoa
楙	mzvaoa
髦	mzviuv
瑁	mzvvia
您	nbiuoa
溺	ncaava
尿	ncavaa
嬲	nciaau
茑	nciiua
鸟	ncuaoa
袅	ncuaov
脲	ncuavu
乜	ndaaa
陧	ndaioi
涅	ndaoiv
嵲	ndiaui
孽	ndiiai
菍	ndiiio
糵	ndiiou
蘖	ndiivv
镍	ndioui
镊	ndiovi
捏	ndiuoi
摄	ndiuvi
啮	ndoivi
蹑	ndoivi
嗫	ndovii
臬	nduivv
聂	ndviao
颞	ndvivu
耨	ndvvvu
那	neavai
讷	neoaia
呢	neoavu
哪	neoavv
呐	neoiau
难	nfaoio
婻	nfauuo
囡	nfiaau
男	nfiaau
蝻	nfiauo
萳	nfiiuo
喃	nfouoi
南	nfuoia
腩	nfuuoi
赧	nfvoai
楠	nfvuoi
泞	ngaooa
拧	ngiuoo
佞	ngivva
咛	ngoooa
甯	ngoooa
宁	ngoovi
凝	ngovua
狞	nguaoo
聍	ngvioo
柠	ngvooa
奶	nhauau
鼐	nhauia
乃	nhauu
艿	nhiiau
萘	nhiivu
佴	nhivii
虐	nhivva
疟	nhovva
氖	nhuvau
迺	nhvioa
耐	nhvuvi
奈	nhvuvv
柰	nhvvvi
驽	njauaa
孥	njauai
奴	njauao
努	njauau
弩	njauav
胬	njauia
怒	njauoa
砮	njauvu
傉	njivuv
笯	njuvau
溺	nkaava
泥	nkaavu
𨺙	nkaiui
妮	nkauav
尼	nkavua
睨	nkiaui
伲	nkiavu
薿	nkiiua
铌	nkioav
你	nkiuai
拟	nkiuao
倪	nkiuiv
呢	nkoavu
昵	nkoiav
怩	nkooav
逆	nkouoa
麑	nkovui
旎	nkovuv
疑	nkuaao
猊	nkuaui
鲵	nkuaui
腻	nkuvvi
匿	nkviiv
坭	nkvoav
霓	nkvoui
娜	nlauav
女	nlauvv
那	nlavai
傩	nliaoi
𦰡	nliiav
钕	nlioau
锘	nlioii
挪	nliuav
搦	nliuav
诺	nloaii
喏	nloiiv
懦	nloovo
糯	nlouvo
衄	nluiai
恧	nlvuoa
蔫	nmiivi
念	nmiooa
捻	nmiuio
拈	nmiuiv
撵	nmiuvv
粘	nmouiv
鲇	nmuaiv
黏	nmuviv
年	nmuvvi
辗	nmvaav
廿	nmviiv
埝	nmvoio
碾	nmvuav
辇	nmvvva
嫩	nnauvi
恁	nniuoa
攮	npiuvi
曩	npoiov
囔	npovia
馕	npuavi
齉	npuivi
囊	npvioo
纽	nqaaai
妞	nqauai
钮	nqioai
拗	nqiuaa
扭	nqiuai
忸	nqooai
狃	nquaai
牛	nquvvi
杻	nqvavi
能	nraoua
纳	nsaaia
乸	nsaiaa
娜	nsauav
那	nsavai
𦰡	nsiiav
钠	nsioia
镎	nsioiv
捺	nsiuvu
拿	nsiviu
衲	nsoaia
哪	nsoavv
呐	nsoiau
肭	nsuiau
南	nsuoia
暖	ntoiuo
那	nwavai
内	nwiauo
哪	nwoavv
馁	nwuauo
娘	nxauoa
酿	nxvioa
浓	nyaoau
侬	nyioau
农	nyoaua
哝	nyooau
脓	nyuoau
秾	nyuvoa
弄	nyvvvu
淖	nzaivi
蛲	nziava
铙	nziova
挠	nziuva
呶	nzoauv
闹	nzoiov
恼	nzooov
猱	nzuaao
峱	nzuaav
脑	nzuovu
臑	nzuvoa
垴	nzvoov
孬	nzvuau
硇	nzvuui
瑙	nzvvaa
桡	nzvvau
嫔	pbauoo
姘	pbauou
拚	pbiuao
拼	pbiuou
颦	pbivui
频	pbivvu
品	pboooo
贫	pbuoao
牝	pbuvua
聘	pbviia
榀	pbvooo
玭	pbvvvi
缥	pcaavi
骠	pcaavi
嫖	pcauvi
漂	pcavia
瞟	pciavi
螵	pciavi
薸	pciiav
嘌	pcovia
膘	pcuvia
剽	pcviii
朴	pcvioo
飘	pcviua
瓢	pcviuu
票	pcvivv
殍	pcvuuo
苤	pdiivu
撇	pdiuou
掊	pdiuov
抔	pdiuvu
瞥	pdouia
剖	pdovii
裒	pdovui
氕	pduvuu
垺	pdvouo
爿	pfaivu
泮	pfaouv
潘	pfauou
畔	pfiaou
盼	pfiauo
蟠	pfiauo
拌	pfiuou
袢	pfoaou
襻	pfoavu
蹒	pfoiii
判	pfouii
叛	pfouuu
番	pfuoia
胖	pfuouv
盘	pfuuia
磐	pfuuvu
槃	pfuuvv
柈	pfvouv
磻	pfvuuo
攀	pfvuvu
涄	pgaiav
洴	pgaouv
娉	pgauia
淜	pgauuu
屏	pgavou
帡	pgiaou
蚲	pgiavo
俜	pgiiav
萍	pgiiav
荓	pgiiou
苹	pgiivo
凭	pgiuua
评	pgoavo
瓶	pgouva
冯	pgovaa
呯	pgovou
鲆	pguavo
乒	pguiuu
平	pgvouv
坪	pgvovo
枰	pgvvou
玶	pgvvvo
湃	phaiuv
派	phauuu
蒎	phiiau
俳	phiivv
排	phiuiv
拍	phiuui
哌	phouuu
迫	phuioa
牌	phuiui
徘	phuuiv
簰	phuvui
濮	pjaiii
瀑	pjaoiv
潽	pjaouv
浦	pjavia
溥	pjavia
圃	pjiavi
蒲	pjiiav
蒱	pjiiiu
仆	pjiioo
菩	pjiiov
葡	pjiiua
莆	pjiivi
镤	pjioii
镨	pjioou
铺	pjiovi
堡	pjiovo
扑	pjiuio
谱	pjoaou
蹼	pjoiii
噗	pjoiio
曝	pjoioi
暴	pjoivi
普	pjouoi
匍	pjuavi
脯	pjuvia
穙	pjuvii
氆	pjuvou
朴	pjvioo
酺	pjvivi
墣	pjvoii
埔	pjvovi
璞	pjvvii
澼	pkaauo
纰	pkaava
陂	pkaiau
淠	pkaiav
陴	pkaiui
阰	pkaiv
疋	pkaivu
皮	pkauao
濞	pkauia
媲	pkauui
劈	pkavau
䴙	pkavov
譬	pkavov
辟	pkavov
屁	pkavva
甓	pkavva
罴	pkiaoo
睥	pkiaui
蜱	pkiaui
毗	pkiav
蚍	pkiava
罢	pkiavo
僻	pkiavu
芘	pkiiva
苉	pkiivu
铍	pkioau
披	pkiuau
擗	pkiuav
批	pkiuva
仳	pkivau
伾	pkivui
被	pkoaau
裨	pkoaui
噼	pkoavu
啤	pkouia
吡	pkovau
疲	pkovau
癖	pkovav
庀	pkovua
痞	pkovvu
鲏	pkuaau
狉	pkuavu
郫	pkuiai
貔	pkuoui
脾	pkuuia
圮	pkvoav
霹	pkvoav
埤	pkvoui
鼙	pkvoui
嚭	pkvovu
坯	pkvovu
匹	pkvuaa
邳	pkvuai
否	pkvuoo
砒	pkvuva
丕	pkvuvv
枇	pkvvau
琵	pkvvva
婆	plaaau
泼	plaaua
陂	plaiau
泊	plauia
颇	plauvu
䥽	plioau
钋	plioio
钷	pliovo
攴	plivao
跛	ploiau
哱	plouoo
粕	plouui
迫	pluioa
魄	pluiui
皤	pluiuo
鄱	pluoai
繁	pluvaa
笸	pluvvo
酦	plviau
朴	plvioo
叵	plvoaa
坡	plvoau
破	plvuau
珀	plvvui
骗	pmaaoa
骈	pmaaou
㛹	pmauiv
偏	pmioav
便	pmivia
翩	pmoaao
扁	pmoaia
谝	pmoaoa
蹁	pmoioa
片	pmuiva
胼	pmuouv
犏	pmuvoa
篇	pmuvoa
楩	pmvivi
𡎚	pmvooa
湓	pnauoa
喷	pnouov
盆	pnuoia
滂	ppaovo
螃	ppiaov
旁	ppovov
庞	ppovvu
逄	ppuaoa
鳑	ppuaov
乓	ppuioo
胖	ppuouv
膀	ppuovo
彷	ppuuov
雱	ppviov
磅	ppvuov
耪	ppvvov
澎	pravoo
泙	pravou
弸	pravuu
蟛	priavo
芃	priiua
蓬	priiua
苹	priivo
抨	priuvo
捧	priuvv
怦	proovo
嘭	provoo
烹	provoo
朋	pruuu
鹏	pruuua
膨	pruvoo
篷	pruvua
堋	prvouu
彭	prvouu
椪	prvouv
碰	prvuou
棚	prvuuu
硼	prvuuu
砰	prvuvo
潖	psavvi
帕	psiaui
芭	psiiai
葩	psiiui
钯	psioai
扒	psiuuo
趴	psoiuo
啪	psoiuu
怕	psooui
叭	psouoo
爬	psuuai
舥	psuuai
筢	psuviu
杷	psvaiv
琶	psvvai
耙	psvvai
辔	pwaaoo
淠	pwaiav
陪	pwaiov
赔	pwaoov
沛	pwavia
帔	pwiaau
锫	pwioov
佩	pwiuav
裴	pwivov
呸	pwovui
旆	pwovuv
衃	pwuivu
胚	pwuvui
配	pwviav
醅	pwviov
霈	pwvoav
培	pwvoov
坏	pwvovu
泡	pzauaa
抛	pziuua
袍	pzoaua
跑	pzoiua
咆	pzouaa
炮	pzouua
庖	pzovua
疱	pzovua
刨	pzuaii
狍	pzuaua
鲍	pzuaua
脬	pzuuoo
匏	pzvuua
骎	qbaaav
沁	qbaoao
矜	qbaoio
溱	qbavvv
嵚	qbiaio
侵	qbiavv
螓	qbiavv
芩	qbiiio
芹	qbiiuu
锓	qbioav
衾	qbioov
钦	qbioua
禽	qbiovu
揿	qbiuio
擒	qbiuio
噙	qboiov
吣	qbooao
寝	qbooov
慬	qboovi
亲	qbovvv
嗪	qbovvv
勤	qbviau
覃	qbvioi
檎	qbviov
琴	qbvvio
秦	qbvvuv
缲	qcaaoo
峭	qciaio
睄	qciaio
瞧	qciaio
峤	qciauv
俏	qciiou
荞	qciiuv
劁	qcioii
锹	qciouv
雀	qciuio
撬	qciuuv
侨	qciuvu
诮	qcoaio
谯	qcoaio
跷	qcoiva
悄	qcooio
憔	qcooio
愀	qcoouv
窍	qcoovi
敲	qcoviv
乔	qcuvui
毳	qcuvuv
翘	qcvaao
鞘	qcviio
樵	qcviov
鞒	qcviuv
巧	qcviva
壳	qcvoua
硚	qcvuuv
硗	qcvuva
桥	qcvuvu
橇	qcvuvv
伽	qdiauo
且	qdiavv
茄	qdiiau
锲	qdiovv
窃	qdoova
怯	qdoovo
惬	qdoovv
妾	qdovau
癿	qduiaa
郄	qduoai
箧	qduvvv
切	qdvaau
趄	qdvoia
砌	qdvuva
挈	qdvviu
浙	qeaiuu
蔗	qeiiov
锗	qeiouo
摺	qeiuao
蛰	qeiuia
蜇	qeiuia
晢	qeiuoi
哲	qeiuoo
折	qeiuuu
褶	qeoaao
谪	qeoaov
褚	qeoauo
着	qeouia
啫	qeouov
䗪	qeovia
这	qeovoa
遮	qeovoa
鹧	qeovua
者	qeuooi
辙	qevaov
辄	qevavi
赭	qevouo
喆	qevovo
詟	qevuov
磔	qevuua
柘	qevvuo
绽	qfaaoo
沾	qfaivo
湛	qfavii
展	qfavvi
嶦	qfiaua
瞻	qfiaua
崭	qfiava
蘸	qfiivi
搌	qfiuav
偡	qfivii
占	qfivoo
战	qfivva
谵	qfoaua
粘	qfouiv
站	qfoviv
鹯	qfovua
旃	qfovuv
颤	qfovvu
飐	qfuaiv
詹	qfuaov
鳣	qfuaov
毡	qfuviv
辗	qfvaav
斩	qfvauu
栴	qfvuvu
盏	qfvvia
栈	qfvvva
清	qgavvi
黥	qgiaov
圊	qgiavv
蜻	qgiavv
苘	qgiiia
擎	qgiiiu
檠	qgiivv
倾	qgivav
倩	qgivvi
綮	qgoaaa
请	qgoavv
晴	qgoivv
情	qgoovv
勍	qgovau
庼	qgovva
庆	qgovvu
亲	qgovvv
卿	qguaav
鲭	qguavv
謦	qguoov
氢	qguvao
氰	qguvvv
箐	qguvvv
轻	qgvaao
顷	qgvavu
罄	qgvouv
磬	qgvovu
碃	qgvuvv
青	qgvvuu
翟	qhaoio
𨟠	qhiaai
侧	qhiaoi
择	qhiuao
雀	qhiuio
摘	qhiuov
债	qhivvi
砦	qhivvu
阕	qhoiao
阙	qhoiou
宅	qhoouv
窄	qhoouv
寨	qhoovv
炔	qhouav
瘸	qhovau
瘵	qhovua
斋	qhovvu
祭	qhuavv
缺	qhuvav
鹊	qhviua
却	qhvoai
榷	qhvoau
悫	qhvooa
埆	qhvoua
确	qhvuua
碏	qhvuvi
棤	qhvvii
纻	qjaaoo
驻	qjaaov
贮	qjaooo
注	qjaovv
潴	qjauau
渚	qjauov
洙	qjauvv
澍	qjavov
属	qjavui
助	qjiaau
瞩	qjiaav
蠋	qjiaia
蛀	qjiaov
蛛	qjiauv
苎	qjiioo
苧	qjiioo
著	qjiiuo
茱	qjiiuv
伫	qjiooa
铢	qjiouv
住	qjiovv
铸	qjiovv
㑇	qjiuaa
拄	qjiuov
侏	qjiuvv
祝	qjoaou
褚	qjoauo
诸	qjoauo
诛	qjoauv
嘱	qjoavu
躅	qjoiia
烛	qjouia
炷	qjouov
疰	qjovov
麈	qjovov
主	qjovvi
瘃	qjovvu
猪	qjuauo
橥	qjuavv
翥	qjuoao
煮	qjuooo
舳	qjuuia
邾	qjuvai
箸	qjuvuo
竹	qjuvuv
朱	qjuvvi
筑	qjuvvi
竺	qjuvvv
杼	qjvaoa
槠	qjvoau
术	qjvoo
柷	qjvoua
柱	qjvovv
逐	qjvuoa
砫	qjvuov
株	qjvuvv
珠	qjvvuv
呇	qkaaoo
骐	qkaavi
绮	qkaavu
骑	qkaavu
亟	qkaiia
泣	qkaovo
汔	qkauva
婍	qkauvu
汽	qkauvv
沏	qkavaa
漆	qkavia
淇	qkavii
柒	qkavvv
屺	qkiaav
岂	qkiaav
俟	qkiaou
蛴	qkiaov
岐	qkiauo
蜞	qkiavi
畦	qkiavo
崎	qkiavu
芑	qkiiav
蕲	qkiiou
荠	qkiiov
葺	qkiiov
芪	qkiiua
萋	qkiiva
企	qkiivi
萁	qkiivi
䓫	qkiivu
锜	qkiovu
伎	qkiuoa
揭	qkiuoi
歧	qkivuo
綮	qkoaaa
祁	qkoaai
启	qkoaoo
祇	qkoaua
祈	qkoauu
讫	qkoauv
祺	qkoavi
棨	qkoavv
跂	qkoiuo
蹊	qkoiuo
踦	qkoivu
愭	qkoouo
器	qkoovu
嘁	qkovui
齐	qkovui
旗	qkovuv
凄	qkovva
麒	qkovvi
弃	qkovvu
鳍	qkuauo
鲯	qkuavi
𨙸	qkuoai
耆	qkuooi
脐	qkuovu
颀	qkuuvu
乞	qkuvaa
憩	qkuvoa
迄	qkuvoa
气	qkuvva
七	qkvaa
郪	qkvaai
妻	qkvaau
杞	qkvava
綦	qkviaa
桤	qkviai
欺	qkviua
其	qkviuo
期	qkviuu
起	qkvoav
圻	qkvouu
埼	qkvovu
丌	qkvuii
戚	qkvuiv
欹	qkvuua
磜	qkvuua
砌	qkvuva
奇	qkvuvo
碛	qkvuvv
碶	qkvuvv
玘	qkvvav
栖	qkvvia
棋	qkvvii
槭	qkvvua
亓	qkvvui
琪	qkvvvi
契	qkvvvu
琦	qkvvvu
驱	qlaavu
灈	qlaiav
屈	qlavai
渠	qlavvv
黢	qliaao
蛆	qliaia
蛐	qliaia
蠼	qliaia
瞿	qliaio
氍	qliauv
曲	qliavi
岖	qliavu
䓛	qliiav
蕖	qliiav
蘧	qliiiv
苣	qliiva
觑	qlivia
龋	qlivui
诎	qloaai
祛	qloavo
袪	qloavo
阒	qloiia
焌	qlouao
癯	qlovia
竘	qlovua
劬	qluaau
鸲	qluaua
鼩	qluiua
躯	qluivu
朐	qluuao
衢	qluuia
胠	qluvoa
取	qlviao
娶	qlviau
麴	qlviua
去	qlvoao
坥	qlvoia
趋	qlvoua
趣	qlvovi
磲	qlvuav
区	qlvuoa
璩	qlvviv
㭕	qlvvoa
麹	qlvvua
缱	qmaaia
纤	qmaauv
阡	qmaiuv
浅	qmavva
汧	qmavvu
潜	qmavvu
黔	qmiaio
遣	qmiaoa
嵌	qmiavi
岍	qmiavv
伣	qmiiau
荨	qmiiav
蒨	qmiiiv
芡	qmiiua
芊	qmiiuv
茜	qmiivi
钤	qmioio
铅	qmioua
钎	qmiouv
钳	qmiovi
钱	qmiovv
掮	qmiuoa
扦	qmiuuv
仟	qmiuvi
佥	qmivoo
虔	qmivov
倩	qmivvi
谴	qmoaia
谦	qmoaou
骞	qmooaa
悭	qmooii
搴	qmooiu
慊	qmooou
褰	qmooov
歉	qmouua
前	qmouui
欠	qmuaii
鹐	qmuaua
乾	qmuouv
肷	qmuuai
愆	qmuuoa
千	qmuvii
箝	qmuviu
签	qmuviv
迁	qmuvoa
堑	qmvavo
椠	qmvavv
墘	qmvouo
圲	qmvouv
牵	qmvuuv
杄	qmvuvi
纼	qnaaav
缜	qnaauo
浈	qnaiva
阵	qnaiva
赈	qnaovu
溱	qnavvv
畛	qniaiu
帧	qniaiv
侦	qniiva
葴	qniivu
蓁	qniivv
针	qniouo
镇	qniouo
揕	qniuvi
振	qniuvu
贞	qnivao
袗	qnoaiu
诊	qnoaiu
祯	qnoaiv
鸩	qnoaua
禛	qnoauo
昣	qnoiiu
疹	qnoviu
胗	qnuiuu
真	qnuouo
朕	qnuouv
稹	qnuvuo
箴	qnuvvu
轸	qnvaiu
臻	qnvavv
斟	qnvioo
鬒	qnviuo
桢	qnviva
甄	qnviva
枕	qnvoau
圳	qnvoui
震	qnvovu
砧	qnvuiv
椹	qnvvii
珍	qnvviu
榛	qnvvvv
瑧	qnvvvv
涨	qpaava
障	qpaiov
账	qpaouv
漳	qpaovo
嫜	qpauov
张	qpavuv
嶂	qpiaov
幛	qpiaov
蟑	qpiaov
帐	qpiauv
掌	qpioiu
仉	qpiuaa
仗	qpivuo
暲	qpoiov
鄣	qpovai
瘴	qpovov
章	qpovuo
彰	qpovuu
獐	qpuaov
胀	qpuuva
长	qpuvao
樟	qpvovo
丈	qpvuoo
璋	qpvvov
杖	qpvvuo
泅	qqaiav
巯	qqaoov
赇	qqaovi
湫	qqauvi
虬	qqiaaa
囚	qqiaii
蝤	qqiaou
蚯	qqiaui
艽	qqiiua
萩	qqiiuv
𨱇	qqiovi
仇	qqiuaa
俅	qqivio
遒	qqouoa
糗	qqouui
酋	qqouvi
龟	qquaia
訄	qquaov
犰	qquaua
鳅	qquauv
邱	qquiai
鼽	qquiua
丘	qquivi
秋	qquvou
鹙	qquvua
逑	qqvioa
鞧	qqviou
求	qqviov
裘	qqviov
楸	qqvuvi
璆	qqvvao
球	qqvvvi
烝	qraioo
帧	qriaiv
峥	qriaua
睁	qriaua
蒸	qriiai
铮	qrioua
钲	qriovi
拯	qriuai
挣	qriuua
诤	qroaua
证	qroavi
怔	qroovi
郑	qrouai
症	qrovvi
争	qruaav
狰	qruaua
徵	qruuia
征	qruuvi
筝	qruvua
政	qrviuv
整	qrvivi
正	qrvivi
洽	qsaivo
髂	qsiaoo
葜	qsiivv
拤	qsiuiv
掐	qsiuua
卡	qsivvi
袷	qsoaiv
恰	qsooiv
绻	qtaaou
劝	qtaoau
婘	qtauou
𨟠	qtiaai
圈	qtiaou
蜷	qtiaou
畎	qtiavu
荃	qtiiiv
颧	qtiivu
佺	qtiivv
铨	qtioiv
全	qtivvi
诠	qtoaiv
悛	qtooao
券	qtouau
拳	qtouiu
痊	qtoviv
鳈	qtuaui
鳤	qtuauv
泉	qtuiaa
筌	qtuviv
辁	qtvaiv
权	qtvaoo
醛	qtviii
鬈	qtviou
棬	qtvouv
犬	qtvuoo
瑔	qtvvui
逡	qwaooa
淳	qwaovo
群	qwavou
囷	qwiauv
裙	qwoaav
谆	qwoaov
窀	qwoova
准	qwovio
这	qwovoa
麇	qwovuv
衠	qwuuuo
肫	qwuvai
屯	qwvaia
戕	qxaiva
嫱	qxauuo
强	qxavoi
蜣	qxiaou
戗	qxiava
蔃	qxiiav
蔷	qxiiuo
镪	qxioav
锵	qxioov
锖	qxiovv
抢	qxiuia
襁	qxoaav
呛	qxoiaa
跄	qxoiia
羟	qxouao
炝	qxouia
羌	qxouvv
将	qxovua
腔	qxuooa
枪	qxviaa
墙	qxvouo
樯	qxvuoo
玱	qxvvia
嬛	qyauia
茕	qyiiav
䓖	qyiioo
穷	qyooau
穹	qyooav
筇	qyuvvi
邛	qyviai
蛩	qyviia
銎	qyviio
跫	qyvioi
琼	qyvvov
沼	qzaauo
召	qzauoo
罩	qziaiv
䓬	qziiiv
钊	qzioii
招	qziuau
找	qziuva
诏	qzoaau
肇	qzoaav
昭	qzoiau
曌	qzoioo
照	qzoioo
啁	qzouav
着	qzouia
嘲	qzouoo
旐	qzovuv
兆	qzuoau
朝	qzuouu
爪	qzuuio
笊	qzuvuu
棹	qzvivo
赵	qzvouo
汭	rbaiau
蚋	rbiaia
芮	rbiiia
蕊	rbiioa
蕤	rbiivu
锐	rbioou
睿	rbivia
枘	rbviau
瑞	rbvvia
柔	rdaovv
肉	rdiaii
揉	rdiuao
蹂	rdoiao
宍	rdooov
糅	rdouao
鞣	rdviao
惹	reiioa
热	reiuoo
喏	reoiiv
染	rfauvv
䎃	rfiaao
蚺	rfiaia
冉	rfiaiv
苒	rfiiia
燃	rfouua
然	rfuaoo
髯	rfviia
汝	rjaauv
洳	rjaauv
𦈡	rjaavo
缛	rjaavu
孺	rjaivo
如	rjauoo
嬬	rjauvi
濡	rjavoa
溽	rjavuv
蠕	rjiavo
茹	rjiiau
薷	rjiivo
蓐	rjiivu
铷	rjioau
儒	rjivoa
襦	rjoavo
褥	rjoavu
嚅	rjovoa
乳	rjuoaa
入	rjuoo
颥	rjvovu
辱	rjvuvi
驲	rkaaoi
䒤	rkiioi
日	rkoii
婼	rlauii
弱	rlavav
鄀	rliiai
蒻	rliiav
偌	rliiiv
爇	rliivo
若	rliivu
挼	rliuuo
箬	rluvii
纫	rnaaau
纴	rnaauv
忍	rnauoa
刃	rnauoo
妊	rnauuv
仞	rniauo
人	rniii
荏	rniiiu
葚	rniivi
任	rniuvi
仁	rnivvv
讱	rnoaau
认	rnoaii
衽	rnoauv
饪	rnuauv
稔	rnuvio
壬	rnuviv
轫	rnvaau
韧	rnvvau
瀼	rpaovo
蘘	rpiiov
儴	rpiovo
攘	rpiuov
让	rpoaiv
禳	rpoaov
嚷	rpoovo
瓤	rpovuu
穰	rpuvov
壤	rpvoov
挼	rqiuuo
仍	rriauu
扔	rriuau
阮	rtaivv
媆	rtauvu
朊	rtuvvu
软	rtvaua
堧	rtvovu
瓀	rtvvvo
润	rwaoia
闰	rwoivv
绒	ryaavv
溶	ryaooa
嵘	ryiaii
蝾	ryiaii
蓉	ryiioo
茸	ryiivi
荣	ryiivv
镕	ryiooo
冗	ryoaua
容	ryoouo
熔	ryouoo
狨	ryuavv
肜	ryuuuu
融	ryvoia
榕	ryvooa
瑢	ryvvoo
戎	ryvvua
绕	rzaava
娆	rzauva
荛	rziiva
扰	rziuvu
饶	rzuava
桡	rzvvau
绥	sbaauo
濉	sbaiav
隧	sbaiou
隋	sbaivu
随	sbaivu
祟	sbaivv
尿	sbavaa
睢	sbiaio
岁	sbiaua
眭	sbiavo
髓	sbiavu
荽	sbiiuo
襚	sboaou
谇	sboaov
虽	sboiav
邃	sboooa
遂	sbouoa
燧	sbouou
旞	sbovuv
穟	sbuvou
穗	sbuvvi
碎	sbvuov
璲	sbvvou
溲	sdauiv
瞍	sdiaui
螋	sdiaui
薮	sdiiou
蒐	sdiiui
锼	sdioui
擞	sdiuou
搜	sdiuui
嗾	sdoova
嗖	sdouiv
嗽	sdovia
廋	sdovui
飕	sduaui
馊	sduaui
叟	sduiao
艘	sduuui
涩	seaauo
㴔	seauaa
洓	seavia
铯	seioua
塞	seoovo
色	seuaai
啬	seuoia
穑	seuvuo
瑟	sevvoa
槭	sevvua
璱	sevvvv
参	sfaouu
毵	sfaouv
叁	sfaovv
潵	sfavii
伞	sfiouu
糁	sfouao
馓	sfuavi
散	sfviuv
三	sfvvvv
思	shiaoa
赛	shooao
噻	shoooa
塞	shoovo
鳃	shuaia
腮	shuiav
骕	sjaaav
溯	sjaouv
涑	sjavia
鹔	sjavua
肃	sjavvi
苏	sjiiau
蔌	sjiivi
俗	sjiuoi
僳	sjivia
傃	sjivvi
谡	sjoaia
诉	sjoauu
蹜	sjoioo
宿	sjooiv
窣	sjooov
愫	sjoovv
塑	sjouvo
嗉	sjovvi
稣	sjuauv
觫	sjuavi
夙	sjuavu
簌	sjuvvi
速	sjvioa
粟	sjviou
甦	sjviuv
酥	sjviuv
素	sjvvaa
缌	skaaia
驷	skaaia
糸	skaaiu
涘	skaaou
鸶	skaaua
汜	skaava
丝	skaavv
泗	skaiau
厶	skaoo
姒	skauao
巳	skavaa
澌	skavii
司	skavoo
㟃	skiaav
蛳	skiaiu
思	skiaoa
似	skiaoi
俟	skiaou
兕	skiaua
四	skiaua
伺	skiavo
食	skioav
锶	skioia
撕	skiuvi
咝	skoaaa
祀	skoaav
祠	skoaav
嗣	skoiav
嘶	skovii
凘	skovvi
饲	skuaav
飔	skuaia
虒	skuuiv
私	skuvao
笥	skuvav
楒	skviav
肆	skviav
斯	skviuu
寺	skvovi
死	skvuua
厮	skvuvi
耜	skvvia
缩	slaaoo
娑	slaiau
挲	slaiiu
溹	slauoo
睃	sliaao
莎	sliiai
蓑	sliiov
锁	slioio
些	slivvv
唆	sloaou
唢	sloiou
嗍	sloouv
羧	slouao
嗦	slouoo
索	sluoaa
所	sluuuu
桫	slvaiu
梭	slvaou
琐	slvvio
森	snvvvv
颡	spaovu
桑	spaovv
搡	spiuao
嗓	spoaoa
丧	spuoau
磉	spvuao
僧	srioui
挲	ssaiiu
洒	ssavia
萨	ssiiai
撒	ssiuvi
仨	ssivvv
飒	ssovua
脎	ssuuov
歃	ssuvua
靸	ssviua
卅	ssvuii
蒜	stiivv
狻	stuaao
算	stuvia
酸	stviao
孙	swaiiu
荪	swiiai
隼	swiouo
损	swiuoa
狲	swuaai
飧	swuaio
笋	swuvav
榫	swviov
飱	swvuio
娀	syauvv
淞	syavuo
嵩	syiaov
崧	syiavu
怂	syiioa
耸	syiivi
菘	syiivu
㧐	syiuao
诵	syoaao
讼	syoauo
忪	syoouo
悚	syoovi
宋	syoovv
送	syouoa
竦	syovvi
凇	syovvu
颂	syuovu
松	syvuoa
缫	szaaaa
骚	szaaao
溞	szaaoo
缲	szaaoo
嫂	szauui
搔	sziuao
扫	sziuav
燥	szouoo
瘙	szovao
鳋	szuaao
臊	szuooo
梢	szviou
埽	szvoav
退	tbavoa
蜕	tbiaou
推	tbiuio
褪	tboaav
煺	tbouav
腿	tbuavv
魋	tbuiio
颓	tbuvvu
忒	tbvoao
粜	tcaiou
嬥	tcauao
迢	tcauoa
蜩	tciaua
眺	tciauo
苕	tciiau
佻	tciuov
挑	tciuuo
龆	tcivau
调	tcoaua
祧	tcoauo
跳	tcoiuo
窕	tcoouo
啁	tcouav
鲦	tcuaua
条	tcuavv
朓	tcuuov
笤	tcuvau
髫	tcviau
贴	tdaoiv
帖	tdiaiv
骰	tdiaua
萜	tdiiia
偷	tdiivu
铁	tdiouv
投	tdiuua
头	tdoovu
透	tduvoa
餮	tdvuio
铽	teiovo
特	teuvvo
忑	tevioa
慝	tevioa
忒	tevoao
滩	tfaaoi
澹	tfauav
潭	tfavia
弹	tfavou
炭	tfiavu
菼	tfiiou
贪	tfioao
钽	tfiooi
倓	tfioou
锬	tfioou
镡	tfiovi
摊	tfiuao
探	tfiuoa
忐	tfivoa
袒	tfoaoi
叹	tfoaoo
谈	tfoaou
谭	tfoavi
昙	tfoivv
惔	tfooou
啴	tfooui
郯	tfouai
瘫	tfovao
痰	tfovou
毯	tfuvou
覃	tfvioi
坦	tfvooi
坍	tfvoua
檀	tfvovi
坛	tfvovv
碳	tfvuia
榃	tfvvia
璮	tfvvov
渟	tgaovo
婷	tgauov
汀	tgavii
䗴	tgiauv
蜓	tgiauv
町	tgiavi
葶	tgiiov
莛	tgiiuv
铤	tgiouv
停	tgiovo
挺	tgiuuv
侹	tgiuvi
烃	tgouao
听	tgouuv
烶	tgouuv
庭	tgovuv
亭	tgovvi
艇	tguuuv
廷	tguvao
颋	tguvvu
霆	tgvouv
圢	tgvovi
桯	tgvovv
厅	tgvuvi
梃	tgvuvi
珽	tgvvuv
骀	thaaao
邰	thaoai
台	thaooo
炱	thaoou
汰	thavuo
苔	thiiao
薹	thiivo
钛	thiovu
抬	thiuao
跆	thoiao
呔	thovuo
鲐	thuaao
胎	thuaoo
肽	thuvuo
酞	thvivu
态	thvuoa
太	thvuoo
泰	thvvaa
涂	tjaivv
屠	tjavuo
图	tjiaua
荼	tjiiiv
葖	tjiioo
菟	tjiiua
钍	tjiovo
凸	tjivia
途	tjivoa
突	tjoovu
鹈	tjouua
吐	tjovoo
兔	tjuaia
腯	tjuuuu
徒	tjuuvo
稌	tjuviv
秃	tjuvua
酴	tjviiv
梌	tjvivv
土	tjvoo
堍	tjvoua
㻬	tjvvvo
缇	tkaaoi
绨	tkaaou
涕	tkaoua
媞	tkauoi
屉	tkavvi
荑	tkiiva
锑	tkioou
倜	tkiuav
提	tkiuoi
擿	tkiuov
体	tkiviu
禔	tkoaoi
裼	tkoaoi
剔	tkoiii
踢	tkoioi
蹄	tkoiov
题	tkoivu
惕	tkoooi
悌	tkooou
啼	tkoovo
剃	tkouii
嚏	tkouoo
鹈	tkouua
逖	tkuaoa
鳀	tkuaoi
䴘	tkuuua
棣	tkvavv
醍	tkvioi
趯	tkvoao
梯	tkvoua
替	tkvvoi
瑅	tkvvoi
驼	tlaaoo
驮	tlaavu
陀	tlaioo
沱	tlaooa
沲	tlauva
萚	tliiiu
佗	tliooa
铊	tliooo
侂	tliovu
托	tliuuv
拖	tliuuv
拓	tliuvu
鼍	tloioi
跎	tloioo
唾	tlouvi
庹	tlovav
鸵	tluaoo
魄	tluiui
妥	tluoau
脱	tluouo
乇	tluvaa
箨	tluviu
椭	tlvaiv
酡	tlvioo
橐	tlvivu
柁	tlvooa
坨	tlvooo
砣	tlvuoo
柝	tlvuuv
沺	tmaiav
淟	tmaiav
湉	tmaooi
添	tmavvu
畋	tmiauv
田	tmiavi
佃	tmiiav
黇	tmiiiv
钿	tmioia
掭	tmiuvv
晪	tmoiia
阗	tmoiuo
恬	tmoouv
畑	tmouia
腆	tmuiav
甜	tmuvvi
舔	tmuvvv
填	tmvouo
殄	tmvuiu
忝	tmvviu
兲	tmvvuo
天	tmvvuo
瑱	tmvvuo
烫	tpaaou
汤	tpaauu
淌	tpaiou
溏	tpaovu
帑	tpauia
螳	tpiaio
螗	tpiaov
倘	tpiiou
傥	tpiiou
铴	tpioaa
䣘	tpioai
铛	tpioio
镋	tpioio
镗	tpioio
堂	tpiovo
棠	tpiovv
搪	tpiuov
蹚	tpoiio
嘡	tpoiou
惝	tpooio
羰	tpouia
糖	tpouov
鄌	tpovai
唐	tpovav
饧	tpuaau
躺	tpuiio
膛	tpuiou
樘	tpviou
醣	tpviov
趟	tpvoio
塘	tpvoov
耥	tpvvio
瑭	tpvvov
藤	triiuo
熥	trouao
誊	trouov
疼	trovua
䲢	truouv
滕	truouv
縢	truouv
腾	truouv
螣	truouv
漯	tsaiav
溻	tsaoia
沓	tsaoii
她	tsauai
他	tsiaia
铊	tsiooo
拓	tsiuvu
挞	tsiuvu
褟	tsoaoi
踏	tsoiao
嗒	tsoiii
遢	tsoioa
蹋	tsoioi
阘	tsoioi
趿	tsoiua
闼	tsoivu
它	tsooua
鳎	tsuaoi
獭	tsuavi
鞳	tsviii
榻	tsvoia
塔	tsvoii
塌	tsvooi
彖	ttaavu
湍	ttaiai
疃	ttiaov
团	ttiavi
揣	ttiuia
抟	ttiuvv
煓	ttouia
猯	ttuaia
沌	twavai
臀	twavuu
氽	twiaa
囤	twiava
褪	twoaav
暾	twoiov
忳	twoova
焞	twouov
饨	twuava
鲀	twuava
豚	twuvua
屯	twvaia
坉	twvova
吞	twvvoo
统	tyaaov
通	tyaooa
潼	tyaovo
㛚	tyauao
峒	tyiaia
瞳	tyiaov
峂	tyiaua
同	tyiavo
侗	tyiiav
茼	tyiiia
铜	tyioia
僮	tyiovo
佟	tyiuao
捅	tyiuao
仝	tyiviv
嗵	tyoaoi
哃	tyoiav
曈	tyoiov
恸	tyoovv
烔	tyouia
痛	tyovao
𦒍	tyovao
童	tyovia
鲖	tyuaia
彤	tyuauu
筒	tyuvia
穜	tyuvov
桶	tyvaoi
桐	tyviav
酮	tyviia
垌	tyvoia
橦	tyvovo
砼	tyvuiv
绦	tzaaua
绹	tzaaua
陶	tzaiua
淘	tzauau
滔	tzauoo
洮	tzauov
弢	tzavia
涛	tzavvv
萄	tziiua
掏	tziuua
叨	tzoauu
讨	tzoavi
慆	tzoouo
啕	tzouau
饕	tzovio
逃	tzuooa
鼗	tzuovo
桃	tzvuov
套	tzvuvi
焘	tzvvoo
韬	tzvvuo
梼	tzvvvu
陲	wbaiuv
锤	wbiouv
捶	wbiuuv
倕	wbiuvi
吹	wbouai
炊	wbouua
垂	wbuviv
椎	wbviov
槌	wbvuia
棰	wbvuvi
绸	wdaaua
丑	wdaivv
瞅	wdiauv
畤	wdiavo
帱	wdiavv
畴	wdiavv
雠	wdiooa
犨	wdiovu
仇	wdiuaa
抽	wdiuia
俦	wdivvv
踌	wdoivv
惆	wdooua
瘳	wdovao
臭	wduivu
愁	wduvoa
稠	wduvua
筹	wduvvv
酬	wdviou
椆	wdvuav
澈	weaova
扯	weiuiv
撤	weiuov
㬚	weoiov
彻	weuuva
掣	weuviu
车	wevavi
坼	wevouu
砗	wevuva
绾	wfaaoo
纨	wfaaua
涴	wfaooa
湾	wfaovi
婉	wfauoo
婠	wfauoo
妧	wfauvv
畹	wfiaoo
蜿	wfiaoo
蔓	wfiioi
莞	wfiioo
菀	wfiioo
芄	wfiiua
挽	wfiuua
晚	wfoiua
剜	wfooii
惋	wfoooo
宛	wfooua
完	wfoovv
烷	wfouoo
弯	wfovav
丸	wfuaoo
皖	wfuioo
脘	wfuooa
腕	wfuooa
万	wfvauu
椀	wfvooa
豌	wfvooo
塆	wfvoov
碗	wfvuoo
琬	wfvvoo
顽	wfvvvu
玩	wfvvvv
揣	wgiuia
搋	wgiuuu
啜	wgoaoa
踹	wgoiia
嘬	wgooiv
膪	wguovo
崴	whiavu
外	whuaio
歪	whvuvi
毋	wjaauv
阢	wjaivu
骛	wjaoaa
婺	wjaoau
鹜	wjaoua
鋈	wjauio
妩	wjauvv
浯	wjavia
洿	wjavuo
屋	wjavva
污	wjavva
𣲘	wjavvu
蜈	wjiaov
峿	wjiavi
屼	wjiavu
芴	wjiiua
芜	wjiivv
钨	wjioua
铻	wjiovi
侮	wjiuva
捂	wjiuvi
仵	wjiuvu
伍	wjivia
误	wjoaov
诬	wjoavi
喔	wjoavu
旿	wjoiuv
晤	wjoivi
寤	wjooai
忤	wjoouv
悟	wjoovi
怃	wjoovv
呜	wjouaa
焐	wjouvi
亡	wjovaa
唔	wjovia
於	wjovio
痦	wjovvi
吴	wjovvu
庑	wjovvv
邬	wjuaai
务	wjuaau
乌	wjuaav
勿	wjuauu
鼯	wjuivi
迕	wjuvoa
物	wjuvua
舞	wjuvua
午	wjuvuo
牾	wjuvvi
郚	wjviai
五	wjviav
巫	wjviii
恶	wjvioa
吾	wjvioo
鹀	wjviua
靰	wjvivu
坞	wjvoua
雾	wjvoua
圬	wjvovv
兀	wjvuaa
戊	wjvuau
梧	wjvvia
武	wjvviv
无	wjvvua
杌	wjvvua
鹉	wjvvua
珸	wjvvvi
珷	wjvvvv
驰	wkaaai
池	wkaaia
蚩	wkaiia
媸	wkauai
弛	wkavai
迟	wkavoa
尺	wkavuo
眙	wkiaao
螭	wkiaov
眵	wkiaua
茌	wkiiiv
侈	wkiuao
傺	wkiuao
摛	wkiuov
持	wkiuvo
齿	wkivia
嗤	wkoaii
褫	wkoauu
匙	wkoiua
踟	wkoiuv
叱	wkouaa
炽	wkouou
吃	wkouva
啻	wkovoo
哧	wkovou
痴	wkovuv
瘛	wkovvv
鸱	wkuaua
饬	wkuauv
魑	wkuiov
翅	wkuoao
瓻	wkuova
彳	wkuuii
胣	wkuuva
斥	wkuuvi
笞	wkuvao
篪	wkuvuu
耻	wkviiv
敕	wkviuv
墀	wkvoav
坻	wkvoua
赤	wkvoui
豉	wkvouo
漦	wkvvvu
绰	wlaaiv
渥	wlaavu
淖	wlaivi
涡	wlaoia
戳	wlaova
沃	wlauvu
幄	wliaav
蜗	wliaoi
偓	wliavu
莴	wliioi
握	wliuav
倭	wliuvi
挝	wliuvi
龌	wlivav
逴	wlivoa
龊	wlivoi
啜	wloaoa
喔	wloavu
踔	wloiiv
踒	wloiuv
惙	wlooao
窝	wloooi
斡	wluoio
我	wluviv
肟	wluvva
辍	wlvaao
卧	wlviio
硪	wlvuuv
创	wmiaii
幢	wmiaov
闯	wmoiaa
怆	wmooia
窗	wmooui
噇	wmoovo
疮	wmovia
床	wmovvv
纹	wnaaov
温	wnaoii
汶	wnaovu
蚊	wniaov
芠	wniiov
问	wnoioo
阌	wnoiuo
闻	wnoivi
吻	wnouau
炆	wnouov
紊	wnovaa
瘟	wnovoi
文	wnovuo
刎	wnuaii
鳁	wnuaoi
璺	wnuivv
稳	wnuvua
辒	wnvaoi
榅	wnvoii
雯	wnvoov
韫	wnvvoi
玟	wnvvov
汪	wpavvi
罔	wpiaou
网	wpiauo
旺	wpoivv
惘	wpooia
亡	wpovaa
妄	wpovau
忘	wpovoa
望	wpovvv
魍	wpuiia
往	wpuuov
辋	wpvaia
尪	wpvuvv
王	wpvviv
枉	wpvvvi
歘	wqouua
滃	wrauoa
蕹	wriiov
蓊	wriiuo
嗡	wrouoa
翁	wruoao
鹟	wruoua
瓮	wruova
汊	wsaaoo
叉	wsaooo
娲	wsauoi
姹	wsauoo
婠	wsauoo
娃	wsauvo
洼	wsavov
凹	wsiaia
畖	wsiauu
嵖	wsiavo
蛙	wsiavo
苴	wsiiia
茶	wsiiiv
茬	wsiivu
侘	wsiooa
镲	wsiooo
锸	wsiouv
搽	wsiuii
挖	wsiuoo
插	wsiuuv
佤	wsivaa
衩	wsoaao
诧	wsoaoo
袜	wsoavv
蹅	wsoivo
嚓	wsoooa
察	wsooua
窊	wsoouu
差	wsouvi
𥻗	wsouvo
喳	wsovoi
哇	wsovov
詧	wsuao
猹	wsuavo
馇	wsuavo
岔	wsuoia
刹	wsuoii
腽	wsuoii
邷	wsvaai
瓦	wsvaao
杈	wsvaoo
查	wsvoiv
檫	wsvooa
垞	wsvooo
槎	wsvouv
碴	wsvuvo
楂	wsvvoi
巛	wtaaaa
圌	wtiaia
遄	wtiaoa
串	wtiavi
钏	wtioui
传	wtivva
喘	wtoiai
穿	wtoova
舛	wtuava
川	wtuiii
船	wtuuua
舡	wtuuvi
氚	wtuvui
椽	wtvaav
堾	wtvovv
潍	wwaaav
维	wwaaio
纬	wwaavv
溦	wwaiai
涠	wwaiav
渭	wwaiav
隈	wwaiia
隗	wwaiui
卫	wwaivv
沩	wwaoua
娓	wwauav
洈	wwauav
妫	wwauou
螱	wwavia
慰	wwavoa
洧	wwavuu
尾	wwavuv
𣲗	wwavva
尉	wwavvi
帷	wwiaio
遗	wwiaoa
峗	wwiaua
嵬	wwiaui
胃	wwiauu
巍	wwiauv
畏	wwiava
崴	wwiavu
囗	wwiavv
围	wwiavv
帏	wwiavv
偎	wwiiav
蔚	wwiiav
薇	wwiiuu
萎	wwiiuv
葳	wwiivu
苇	wwiivv
伪	wwioua
位	wwiovo
㧑	wwiuou
伟	wwivva
谓	wwoaia
诿	wwoauv
喂	wwoiav
唯	wwoiov
闱	wwoivv
韪	wwoivv
惟	wwooio
为	wwouao
煟	wwouia
煨	wwouia
炜	wwouvv
亹	wwovui
痿	wwovuv
味	wwovvi
危	wwuaaa
鳚	wwuaav
猥	wwuaia
猬	wwuaia
鳂	wwuaia
鲔	wwuavu
艉	wwuuav
微	wwuuia
委	wwuvau
逶	wwuvoa
魏	wwuvui
霨	wwviav
軎	wwvioo
圩	wwvovv
威	wwvuau
桅	wwvuav
硙	wwvuia
碨	wwvuia
硊	wwvuua
韦	wwvvai
琟	wwvvio
未	wwvviu
违	wwvvoa
玮	wwvvvv
创	wxiaii
幢	wxiaov
闯	wxoiaa
怆	wxooia
窗	wxooui
噇	wxoovo
疮	wxovia
床	wxovvv
涌	wyaaoi
漴	wyaiai
翀	wyaoia
㳘	wyaova
崇	wyiaoo
虫	wyiavi
茺	wyiiov
铳	wyioov
摏	wyiuvv
忡	wyooia
憧	wyooov
宠	wyoovu
冲	wyovia
充	wyovua
艟	wyuuov
种	wyuvia
重	wyuvia
埫	wyvoio
珫	wyvvov
舂	wyvvui
巢	wzaaia
剿	wzaaii
绰	wzaaiv
潮	wzauoo
弨	wzavau
钞	wzioiu
抄	wziuiu
吵	wzoiuo
晁	wzoiuo
怊	wzooau
炒	wzouiu
焯	wzouiv
嘲	wzouoo
朝	wzuouu
超	wzvoau
耖	wzvviu
芯	xbiioa
莘	xbiiov
薪	xbiiov
伈	xbioao
鑫	xbioio
锌	xbioov
镡	xbiovi
信	xbiovv
心	xboaoo
昕	xboiuu
忻	xboouu
炘	xbouuu
歆	xbovua
辛	xbovuo
新	xbovuu
衅	xbuiou
囟	xbuiuo
欣	xbuuua
馨	xbvouv
绡	xcaaio
骁	xcaava
潇	xcaiia
消	xcaiou
洨	xcaovu
姣	xcauov
涍	xcauov
淆	xcauov
蟏	xciaii
蛸	xciaio
崤	xciauo
萧	xciiav
翛	xciiua
削	xcioii
销	xcioio
逍	xciooa
肖	xciouu
小	xciuoo
啸	xcoavv
晓	xcoiva
宵	xcooio
恔	xcooov
咲	xcoouv
敩	xcoouv
嚣	xcoovu
哮	xcouov
哓	xcovau
鸮	xcovua
效	xcovuv
猇	xcuaiv
虓	xcuaiv
枭	xcuavv
魈	xcuiio
皛	xcuiui
孝	xcuoai
箫	xcuvav
筱	xcuvii
篠	xcuvii
笑	xcuvuv
霄	xcvoio
枵	xcvova
校	xcvovu
硝	xcvuio
绁	xdaavi
缬	xdaavo
𠙶	xdaiai
瀣	xdaivu
泻	xdaoav
澥	xdauau
勰	xdauia
泄	xdavii
渫	xdavii
屑	xdavio
沤	xdavuo
蝎	xdiaoi
偶	xdiiav
薢	xdiiua
薤	xdiivu
藕	xdiivv
携	xdiuio
挟	xdiuvo
撷	xdiuvo
揳	xdiuvv
偕	xdivau
斜	xdivoo
偰	xdivvi
㙦	xdivvo
些	xdivvv
谢	xdoaui
写	xdoava
谐	xdoava
讴	xdoavu
躞	xdoiov
歇	xdoiua
懈	xdooua
怄	xdoovu
叶	xdouoo
吽	xdouvv
燮	xdovao
亵	xdoviu
廨	xdovua
呕	xdovuo
解	xduaau
蟹	xduaia
邂	xduaoa
獬	xduaua
胁	xduauo
鲑	xduavo
血	xduiai
协	xduoau
卸	xduvai
邪	xdvaai
榍	xdvavu
鞋	xdvivo
颉	xdvovu
榭	xdvuia
区	xdvuoa
欧	xdvuua
殴	xdvuua
鸥	xdvuua
瓯	xdvuva
絜	xdvvaa
耦	xdvvia
𤫉	xdvvou
契	xdvvvu
械	xdvvvu
楔	xdvvvv
阿	xeaivo
婀	xeauai
姶	xeauiv
娥	xeauuv
涐	xeauvi
屙	xeavai
崿	xeiaoo
峨	xeiauv
蛾	xeiauv
萼	xeiioo
莪	xeiiuv
苊	xeiivu
锷	xeiooo
锇	xeiouv
俄	xeiuvi
扼	xeiuvu
讹	xeoaiu
谔	xeoaoo
遏	xeoioa
阏	xeoiov
鄂	xeooai
愕	xeoooo
鹗	xeooua
颚	xeoovu
额	xeoovu
哦	xeouvi
呃	xeovua
鳄	xeuaoo
饿	xeuauv
腭	xeuoov
鹅	xeuvua
轭	xevavu
恶	xevioa
噩	xevioo
垩	xevivo
堨	xevooi
厄	xevuaa
𥔲	xevuoo
黯	xfiaov
岸	xfiavu
盦	xfioia
铵	xfiooo
按	xfiuoo
揞	xfiuov
俺	xfivuo
谙	xfoaov
暗	xfoiov
安	xfooau
案	xfoovv
唵	xfovuo
庵	xfovvu
𩽾	xfuaoo
犴	xfuavv
胺	xfuooa
氨	xfuvoo
鞍	xfvioo
桉	xfvooa
垵	xfvooo
埯	xfvovu
鹌	xfvuua
骍	xgaaov
陉	xgaiao
姓	xgauuv
婞	xgauvo
荥	xgiiaa
荇	xgiiuu
钘	xgiovv
铏	xgiovv
省	xgiuia
擤	xgiuui
星	xgoiuv
惺	xgoooi
兴	xgoouo
性	xgoouv
悻	xgoovo
煋	xgouoi
饧	xguaau
猩	xguaoi
腥	xguoiu
行	xguuvv
醒	xgvioi
杏	xgvoo
幸	xgvoou
硎	xgvuvv
邢	xgvvai
刑	xgvvii
瑆	xgvvoi
形	xgvvuu
型	xgvvvo
隘	xhaiou
欸	xhaoua
嫒	xhauuo
彐	xhavvv
蔼	xhiioa
茓	xhiioo
薛	xhiiui
艾	xhiiuo
削	xhioii
锿	xhioov
挨	xhiuao
踅	xhiuoi
捱	xhiuvu
诶	xhoaao
谑	xhoaiv
唉	xhoaou
哎	xhoiiu
暧	xhoiuo
噱	xhoiva
泶	xhooaa
学	xhooai
峃	xhooia
穴	xhoouo
嗌	xhoouv
嗳	xhouoo
癌	xhovoo
哀	xhovou
鳕	xhuavo
血	xhuiai
皑	xhuiia
爱	xhuovu
矮	xhuvuv
靴	xhviiu
毐	xhvoaa
埃	xhvoao
雪	xhvoav
霭	xhvooa
砹	xhvuii
碍	xhvuoi
叆	xhvvuo
瑷	xhvvuo
陑	xjaivu
洱	xjavii
峏	xjiavu
铒	xjiovi
佴	xjivii
咡	xjovii
呒	xjovvu
儿	xjuaa
尔	xjuaiu
迩	xjuaoa
饵	xjuavi
鲕	xjuavu
耳	xjviiv
而	xjvuia
鸸	xjvuua
耏	xjvuuu
贰	xjvvao
二	xjvvv
珥	xjvvvi
细	xkaaia
绤	xkaauo
隙	xkaiiu
隰	xkaioi
枲	xkaoov
戏	xkaova
习	xkaovv
汐	xkauao
潟	xkauiv
溪	xkauoo
浠	xkauov
媳	xkauui
洗	xkauvi
嬉	xkauvo
屃	xkavao
犀	xkavau
屣	xkavuu
淅	xkavuu
酅	xkiaai
嶍	xkiaao
巇	xkiaiv
螅	xkiaui
睎	xkiauo
蟋	xkiauo
蜥	xkiavu
葸	xkiiia
蓰	xkiiuu
茜	xkiivi
菥	xkiivu
锡	xkiooi
铣	xkiouv
傒	xkiuoo
俙	xkiuov
翕	xkivao
僖	xkivoo
歙	xkivua
裼	xkoaoi
䜣	xkoauu
禧	xkoavo
禊	xkoavv
曦	xkoiou
阋	xkoiui
晞	xkoiuo
蹊	xkoiuo
暿	xkoivo
晰	xkoivu
穸	xkooua
窸	xkoouo
忾	xkoouv
恓	xkoovi
惜	xkoovi
吸	xkouao
熻	xkouiv
爔	xkouou
唏	xkouov
熄	xkouui
烯	xkouuo
羲	xkouuv
粞	xkouvi
席	xkovia
𠅤	xkovia
嘻	xkovoo
鳛	xkuaao
觿	xkuaia
系	xkuaiu
夕	xkuaoo
饻	xkuaov
饩	xkuauv
玺	xkuavv
息	xkuioa
舄	xkuiua
鼷	xkuiuo
奚	xkuoaa
郗	xkuoai
郤	xkuoai
悉	xkuooa
欷	xkuoua
谿	xkuouo
兮	xkuova
希	xkuovu
徙	xkuuiv
肸	xkuuou
舾	xkuuvi
膝	xkuvia
腊	xkuvii
稀	xkuvuo
牺	xkuvvi
樨	xkvavu
西	xkviau
觋	xkviia
昔	xkvioi
熙	xkvioo
醯	xkviov
憙	xkvooa
喜	xkvooo
熹	xkvooo
檄	xkvuia
袭	xkvuov
矽	xkvuua
皙	xkvuui
豨	xkvuuo
析	xkvuuv
硒	xkvuvi
栖	xkvvia
湑	xlaaiv
绪	xlaauo
续	xlaauo
胥	xlaiuu
溆	xlaivv
浒	xlaoau
矞	xlaoia
絮	xlauaa
婿	xlauai
洫	xlauia
勖	xliaau
冔	xliaov
盱	xliavv
蓿	xliioo
蓄	xliiov
叙	xlivao
虚	xlivii
谞	xloaai
诩	xloaao
许	xloauv
喔	xloavu
煦	xloioo
昫	xloiua
嘘	xloiva
旴	xloivv
恤	xlooui
糈	xlouai
呴	xlouao
噢	xlouia
欻	xlouua
哦	xlouvi
序	xlovao
畜	xlovia
吁	xlovvi
旭	xluaoi
魆	xluiva
媭	xluuau
徐	xluuiv
须	xluuvu
栩	xlvaov
醑	xlviai
酗	xlviuo
墟	xlvoiv
垿	xlvoov
需	xlvovu
圩	xlvovv
戌	xlvuvv
珝	xlvvao
砉	xlvvvu
顼	xlvvvu
缐	xmaaui
纤	xmaauv
线	xmaavv
限	xmaiav
险	xmaiiv
陷	xmaiua
孅	xmauii
涎	xmauiv
娴	xmauoi
嫌	xmauou
弦	xmavov
县	xmiaao
岘	xmiaia
蚬	xmiaia
崄	xmiaiv
盷	xmiaua
见	xmiaua
仙	xmiiai
贤	xmiiao
苋	xmiiia
莶	xmiiiv
藓	xmiiua
锨	xmiouu
铣	xmiouv
伭	xmiova
掺	xmiuao
挦	xmiuav
掀	xmiuuu
禒	xmoaaa
诜	xmoauv
祆	xmoavv
㬎	xmoiaa
显	xmoiii
暹	xmoioa
鹇	xmoiua
跣	xmoiuv
跹	xmoiuv
闲	xmoivv
忺	xmooua
宪	xmoouv
籼	xmouia
羡	xmouov
咁	xmovii
痫	xmovoi
冼	xmovuv
猃	xmuaiv
鲜	xmuaou
狝	xmuaua
馅	xmuaua
𤞤	xmuavi
献	xmuovu
腺	xmuuia
衔	xmuuio
舷	xmuuov
氙	xmuvia
先	xmuvua
筅	xmuvuv
酰	xmviuv
霰	xmvovi
咸	xmvuoo
燹	xmvuou
现	xmvvia
恩	xniaoa
蒽	xniiia
摁	xniuia
嗯	xnoiav
唔	xnovia
盎	xpiaia
昂	xpoiua
肮	xpuovu
绣	xqaauv
滫	xqaiua
溴	xqauia
岫	xqiaia
䗛	xqiaii
修	xqiiua
脩	xqiiua
锈	xqiouv
鸺	xqivua
休	xqivv
袖	xqoaia
咻	xqoivv
宿	xqooiv
羞	xqouai
嗅	xqouia
庥	xqoviv
馐	xquaou
臭	xquivu
貅	xquoiv
秀	xquvau
髹	xqviiv
朽	xqvvaa
琇	xqvvuv
珛	xqvvvu
嗯	xroiav
唔	xrovia
阿	xsaivo
遐	xsavoa
翈	xsiaao
瞎	xsiaoo
虾	xsiavi
峡	xsiavo
黠	xsiavo
锕	xsioai
侠	xsivou
啊	xsoaiv
呷	xsoiav
暇	xsoiav
吖	xsooui
瘕	xsovav
吓	xsovio
嗄	xsovui
狎	xsuaia
狭	xsuavo
罅	xsuviv
腌	xsuvuo
辖	xsvaoo
匣	xsviav
柙	xsviav
下	xsvioo
霞	xsvoav
槎	xsvouv
夏	xsvuua
硖	xsvuvo
厦	xsvuvu
瑕	xsvvav
绚	xtaaua
渲	xtaooa
泫	xtaova
漩	xtaova
嬛	xtauia
翾	xtiaao
悬	xtiaoa
眩	xtiaov
儇	xtiiai
萱	xtiioo
铉	xtioov
镟	xtioov
揎	xtiuoo
禤	xtoaia
谖	xtoauo
暄	xtoioo
暅	xtoioo
昡	xtoiov
暶	xtoiov
晅	xtoivo
吅	xtooo
喧	xtoooa
愃	xtoooo
宣	xtoovo
券	xtouau
煊	xtouoo
炫	xtouov
烜	xtouvo
玄	xtovaa
咺	xtovoi
痃	xtovov
癣	xtovua
旋	xtovuv
衒	xtuuov
选	xtuvoa
轩	xtvavv
楦	xtvooa
碹	xtvuoo
璿	xtvviv
瑄	xtvvoo
琄	xtvvou
玹	xtvvov
璇	xtvvov
巡	xwaaoa
浚	xwaaou
驯	xwaaui
汛	xwaavi
浔	xwaavv
逊	xwaioa
欸	xwaoua
洵	xwauao
迅	xwavoa
寻	xwavvi
巽	xwavvi
峋	xwiaua
荨	xwiiav
荀	xwiiua
薰	xwiiuv
蕈	xwiivi
诶	xwoaao
勋	xwoaau
讯	xwoaav
询	xwoaua
训	xwoaui
噀	xwoava
曛	xwoiuv
窨	xwooov
恂	xwooua
郇	xwuaai
鲟	xwuaav
旬	xwuaoi
獯	xwuauv
徇	xwuuua
循	xwuuuu
熏	xwuvoo
醺	xwviuv
埙	xwvooa
栒	xwvuao
殉	xwvuua
珣	xwvvua
飨	xxaaio
骧	xxaaov
乡	xxaauu
缃	xxaavi
降	xxaiua
湘	xxavia
蟓	xxiaua
芗	xxiiaa
葙	xxiivi
镶	xxioov
像	xxiuai
祥	xxoaou
详	xxoaou
翔	xxouao
响	xxouia
鲞	xxouua
享	xxovoa
襄	xxovoo
庠	xxovou
象	xxuaia
饷	xxuaui
向	xxuioo
香	xxuvoi
箱	xxuvvi
巷	xxviav
相	xxviav
想	xxvioa
项	xxvivu
橡	xxvuai
厢	xxvuvi
瓖	xxvvov
珦	xxvvui
熊	xyaooo
汹	xyauoa
芎	xyiiav
诇	xyoaia
讻	xyoauo
兄	xyouaa
夐	xyuaua
匈	xyuauo
凶	xyuoai
胸	xyuuau
雄	xyvuio
隩	xzaiui
澳	xzauia
媪	xzauoi
凹	xziaia
艹	xziii
拗	xziuaa
傲	xzivvi
袄	xzoauv
懊	xzooui
噢	xzouia
鏖	xzovio
嗷	xzovvi
廒	xzovvv
翱	xzuiao
奥	xzuivu
岙	xzuvia
坳	xzvoaa
奡	xzvuvu
骜	xzvvaa
嶅	xzvvia
螯	xzvvia
鏊	xzvvio
遨	xzvvoa
熬	xzvvoo
鳌	xzvvua
敖	xzvvuv
聱	xzvvvi
獒	xzvvvu
璈	xzvvvv
骃	ybaaia
洇	ybaiav
隐	ybaiua
阴	ybaiuu
姻	ybauia
淫	ybauoo
溵	ybauua
引	ybavii
尹	ybavvu
蚓	ybiaav
崟	ybiaio
蟫	ybiavi
因	ybiavu
荫	ybiiai
茵	ybiiia
茚	ybiiua
银	ybioav
铟	ybioia
龈	ybivav
龂	ybivuu
冘	yboaua
吲	yboava
禋	yboavi
吟	yboioa
訚	yboiov
愔	ybooov
窨	ybooov
嚚	yboovi
寅	yboovi
喑	yboovo
瘾	ybovai
音	ybovoi
印	ybuaai
胤	ybuaao
夤	ybuaoo
狺	ybuaov
䲟	ybuaua
饮	ybuaua
殷	ybuuua
氤	ybuvia
鄞	ybviai
霪	ybvoau
垠	ybvoav
慭	ybvooa
圻	ybvouu
堙	ybvovi
珢	ybvvav
幼	ydaaau
油	ydaiav
浟	ydaiiu
又	ydaoo
游	ydaova
蚴	ydiaaa
黝	ydiaaa
邮	ydiaai
幽	ydiaao
蚰	ydiaia
蝤	ydiaou
蝣	ydiaov
由	ydiavi
囿	ydiavu
莜	ydiiii
悠	ydiioa
莸	ydiiua
攸	ydiiuv
莠	ydiiuv
铀	ydioia
铕	ydiovu
卣	ydivia
优	ydivua
佑	ydivuo
侑	ydivuu
呦	ydoaao
冘	ydoaua
诱	ydoauv
祐	ydoavu
宥	ydoovu
忧	ydoovu
羑	ydouua
猷	ydouvu
麀	ydovai
疣	ydovvu
鲉	yduaia
犹	yduavu
鱿	yduavu
鼬	yduiia
牖	yduioa
釉	yduoia
繇	yduoua
酉	ydviau
柚	ydviav
尢	ydvuaa
友	ydvuao
尤	ydvuao
右	ydvuoo
有	ydvuuu
槱	ydvvia
耰	ydvvvu
也	yeaiaa
液	yeaovi
野	yeiaao
曳	yeiavv
邺	yeiiai
业	yeiiou
铘	yeiova
拽	yeiuia
掖	yeiuov
揶	yeiuvi
倻	yeivii
吔	yeoaia
谒	yeoaoi
咽	yeoiav
晔	yeoiiu
喝	yeooiu
烨	yeouiu
叶	yeouoo
冶	yeovao
夜	yeoviu
噎	yeovoo
馌	yeuavo
射	yeuivi
爷	yeuoai
腋	yeuovi
邪	yevaai
耶	yeviai
页	yevuao
靥	yevuvu
椰	yevvii
验	yfaaiv
沇	yfaaou
渰	yfaivo
演	yfaooa
沿	yfauao
嫣	yfauvi
嬿	yfauvi
妍	yfauvv
湮	yfavia
漹	yfaviv
淹	yfavuo
滟	yfavvv
觃	yfiaai
眼	yfiaav
蜒	yfiaui
蝘	yfiavo
岩	yfiavu
崦	yfiavu
罨	yfiavu
菸	yfiiov
芫	yfiivv
掩	yfiuvu
俨	yfivii
虤	yfiviv
偃	yfivoi
甗	yfivva
弇	yfivvu
扊	yfoaou
谚	yfoaov
谳	yfoauo
咽	yfoiav
晏	yfoioo
阎	yfoiua
阉	yfoivu
闫	yfoivv
宴	yfoooi
戭	yfoova
恹	yfoovu
唁	yfoovv
烟	yfouia
剡	yfouii
炎	yfouou
焱	yfouou
焰	yfouua
烻	yfovui
兖	yfovuo
彦	yfovuu
颜	yfovvu
言	yfovvv
延	yfuiao
胭	yfuiav
鼹	yfuioi
衍	yfuuav
殷	yfuuua
筵	yfuvui
腌	yfuvuo
鄢	yfviai
严	yfviio
燕	yfvioo
歅	yfviua
焉	yfviva
酽	yfvivi
郾	yfvoai
盐	yfvoia
棪	yfvoou
埏	yfvoui
墕	yfvovi
堰	yfvovo
赝	yfvuao
檐	yfvuav
厣	yfvuia
奄	yfvuia
砚	yfvuia
黡	yfvuia
雁	yfvuii
餍	yfvuio
魇	yfvuui
厌	yfvuvu
䶮	yfvuvv
研	yfvuvv
琰	yfvvou
艳	yfvvua
缨	ygaaao
溁	ygaiio
滢	ygaiio
潆	ygaiio
婴	ygaoau
鹦	ygaoua
罂	ygaouv
瀛	ygaova
盈	ygauia
媖	ygauii
蝇	ygiaoi
颙	ygiavu
荥	ygiiaa
萦	ygiiaa
英	ygiiia
萤	ygiiia
蓥	ygiiio
营	ygiioo
荧	ygiiou
莺	ygiiua
䓨	ygiiuv
茔	ygiivo
莹	ygiivv
锳	ygioii
撄	ygiuao
嘤	ygoaoa
映	ygoiia
影	ygoiuu
郢	ygovai
瘿	ygovao
应	ygovoo
嬴	ygovou
赢	ygovou
鹰	ygovua
膺	ygovuu
迎	yguaoa
颍	yguavu
颖	yguavu
媵	yguouv
樱	ygvaoa
楹	ygvaua
硬	ygvuvi
璎	ygvvao
瑛	ygvvii
约	yhaaua
瀹	yhaivo
钥	yhiouu
钺	yhiova
龠	yhivoo
说	yhoaou
哕	yhoiai
曰	yhoii
阅	yhoiou
跃	yhoiuv
悦	yhooou
爚	yhouiv
乐	yhuaiu
岳	yhuiia
刖	yhuiii
粤	yhuiva
月	yhuu
籥	yhuviv
戉	yhvaau
越	yhvova
栎	yhvuai
樾	yhvvoi
玥	yhvvuu
乙	ykaa
绎	ykaaao
驿	ykaaao
彝	ykaaou
缢	ykaaou
洢	ykaiav
潩	ykaiav
浥	ykaoai
贻	ykaoao
翼	ykaoia
以	ykaoii
翌	ykaoov
溢	ykaouv
矣	ykaouv
羿	ykaovu
㴔	ykauaa
漪	ykauau
沂	ykauuv
姨	ykauva
嫕	ykauvu
已	ykavaa
尾	ykavuv
异	ykavvu
亿	ykiaa
峄	ykiaao
眙	ykiaao
遗	ykiaoa
蜴	ykiaoi
佁	ykiaoo
蛇	ykiaoo
蚁	ykiaou
螠	ykiaou
嶷	ykiaua
黟	ykiaua
屹	ykiauv
伊	ykiavv
艺	ykiiaa
苡	ykiiao
薏	ykiiov
艾	ykiiuo
荑	ykiiva
钇	ykioaa
食	ykioav
镒	ykioou
铱	ykioov
镱	ykioov
仪	ykiouo
㑊	ykiovu
依	ykiovu
挹	ykiuoa
佾	ykiuou
揖	ykiuov
抑	ykiuua
仡	ykiuva
佚	ykiuvv
倚	ykivuo
译	ykoaao
诒	ykoaao
邑	ykoaiv
谊	ykoaoo
议	ykoaou
扆	ykoaov
扅	ykoaua
诣	ykoaua
祎	ykoavv
咿	ykoiav
呓	ykoiia
易	ykoiua
忆	ykooaa
怡	ykooao
怿	ykooao
宜	ykooia
悒	ykoooa
嗌	ykoouv
宧	ykoovi
噫	ykoovo
熠	ykouao
益	ykouia
义	ykouoo
燚	ykouou
翊	ykovao
咦	ykovav
廙	ykovia
裔	ykovia
意	ykovoa
裛	ykovoa
癔	ykovov
毅	ykovua
疫	ykovua
衣	ykovua
亦	ykovui
旖	ykovuv
痍	ykovva
瘗	ykovvo
奕	ykovvu
弈	ykovvu
疑	ykuaao
饴	ykuaao
肄	ykuaav
逸	ykuaoa
猗	ykuavu
劓	ykuiii
射	ykuivi
刈	ykuoii
乂	ykuoo
鹢	ykuoua
臆	ykuovo
舣	ykuuou
役	ykuuua
胰	ykuvav
迤	ykuvoa
移	ykuvua
簃	ykuvuv
匜	ykvaia
弋	ykvaoo
轶	ykvauv
夷	ykvava
酏	ykviai
勚	ykviau
颐	ykvivu
圯	ykvoav
埸	ykvooi
懿	ykvoov
鹝	ykvoua
椸	ykvova
壹	ykvovo
繄	ykvuaa
翳	ykvuao
枍	ykvuov
欹	ykvuua
殪	ykvuvo
医	ykvuvv
杙	ykvvao
椅	ykvvuo
一	ykvvv
驭	ylaaao
滪	ylaaoa
潏	ylaaoa
纡	ylaavv
隅	ylaiia
隃	ylaiiv
渝	ylaivu
予	ylaoai
羽	ylaoao
矞	ylaoia
汩	ylaoii
遹	ylaooa
豫	ylaoua
鹬	ylaoua
淤	ylaova
淯	ylaova
预	ylaovu
渔	ylauai
妤	ylauao
浴	ylauoi
娱	ylauov
妪	ylauvu
㳚	ylavuo
尉	ylavvi
鬻	ylavvo
聿	ylavvv
嵎	yliaia
髃	yliaia
嵛	yliaiv
蝓	yliaiv
愚	yliaoa
遇	yliaoa
峪	yliauo
屿	yliava
圄	yliavi
圉	yliavo
蜮	yliavo
禺	yliavv
蓣	yliiao
萸	yliiui
薁	yliiui
芋	yliivv
俣	yliovv
钰	yliovv
揄	yliuiv
觎	ylivia
悆	ylivoa
愈	ylivoa
逾	ylivoa
虞	ylivov
俞	ylivui
伛	ylivuo
龉	ylivvi
余	ylivvv
哟	yloaav
褕	yloaiv
谕	yloaiv
谀	yloaui
裕	yloauo
语	yloavi
喁	yloiav
昱	yloiov
阏	yloiov
阈	yloivo
喻	yloivu
寓	ylooia
愉	ylooiv
窬	ylooiv
誉	ylooov
窳	yloouu
唷	yloova
宇	yloovv
燏	ylouao
煜	ylouoi
燠	ylouui
於	ylovio
瘀	ylovov
庾	ylovui
瘐	ylovui
育	ylovuu
吁	ylovvi
鱼	yluaia
㺄	yluaiv
狳	yluaiv
馀	yluaiv
狱	yluaoa
饫	yluauv
鄅	yluiai
禹	yluiav
舆	yluiuo
臾	yluiva
舁	yluivu
欲	yluoua
鹆	yluoua
腴	yluuiv
艅	yluuiv
御	yluuuv
毓	yluvov
竽	yluvvv
欤	ylvaua
与	ylvavv
雨	ylviai
敔	ylviuv
榆	ylvivu
堉	ylvoov
圫	ylvouv
彧	ylvova
域	ylvovo
雩	ylvovv
郁	ylvuai
邘	ylvvai
盂	ylvvia
于	ylvvii
玉	ylvviv
瑜	ylvviv
迂	ylvvoa
棫	ylvvov
瑀	ylvvui
玙	ylvvva
泱	ypaiav
阳	ypaioi
洋	ypaouv
漾	ypaouv
蛘	ypiaou
鸯	ypiaua
央	ypiavu
钖	ypioau
佯	ypiouv
仰	ypiuaa
扬	ypiuau
旸	ypoiau
咉	ypoiav
怏	ypooia
炀	ypouau
恙	ypouoa
羕	ypouoa
烊	ypouou
养	ypouui
羊	ypouvv
疡	ypovau
痒	ypovou
卬	ypuaai
飏	ypuaau
徉	ypuuou
秧	ypuvia
氧	ypuvou
杨	ypvauu
鞅	ypviia
垟	ypvoou
样	ypvouv
殃	ypvuia
娅	ysauvi
涯	ysavuv
鸭	ysiaua
岈	ysiava
蚜	ysiava
崖	ysiavu
睚	ysiavu
芽	ysiiva
押	ysiuia
揠	ysiuvo
伢	ysivai
讶	ysoava
吖	ysooui
丫	ysouii
呀	ysovai
哑	ysovii
痖	ysovvi
猰	ysuavv
衙	ysuuvi
氩	ysuvvi
轧	ysvaaa
雅	ysvaio
牙	ysvaiu
迓	ysvaoa
鸦	ysvaua
亚	ysviio
垭	ysvovi
堐	ysvovu
砑	ysvuva
压	ysvuvo
枒	ysvvai
桠	ysvvii
玡	ysvvva
琊	ysvvva
缘	ytaaaa
院	ytaioo
贠	ytaoao
湲	ytauoo
渊	ytauou
媛	ytauuo
嫄	ytauvu
源	ytavuu
沅	ytavvu
圜	ytiaia
圆	ytiaoa
蜎	ytiaou
螈	ytiavu
园	ytiavv
苑	ytiiua
薳	ytiivo
芫	ytiivv
掾	ytiuaa
援	ytiuuo
员	ytoaoo
冤	ytoaua
宛	ytooua
鹓	ytooua
羱	ytouvu
眢	ytuaia
怨	ytuaoa
鸳	ytuaua
猿	ytuavo
爰	ytuovv
箢	ytuvoo
橼	ytvaav
鸢	ytvaua
辕	ytvavo
垸	ytvooo
袁	ytvoou
垣	ytvovo
塬	ytvovu
愿	ytvuoa
原	ytvuui
远	ytvvoa
鼋	ytvvoi
元	ytvvua
瑗	ytvvuo
缊	ywaaoi
纭	ywaavv
陨	ywaioa
涢	ywaoao
贠	ywaoao
允	ywaoua
孕	ywauai
妘	ywauvv
熨	ywavou
沄	ywavva
蕴	ywiiaa
蕰	ywiiao
菀	ywiioo
芸	ywiivv
郓	ywoaai
郧	ywoaai
晕	ywoioa
昀	ywoiua
恽	ywoooa
愠	ywoooi
煴	ywouoi
赟	ywovao
韵	ywovua
狁	ywuaao
匀	ywuaov
筼	ywuvoa
氲	ywuvoi
馧	ywuvoi
筠	ywuvvo
酝	ywvivv
鋆	ywvoiv
殒	ywvuoa
云	ywvvao
运	ywvvoa
韫	ywvvoi
耘	ywvvvv
邕	yyaaoa
涌	yyaaoi
泳	yyaoaa
勇	yyaoau
甬	yyaoia
恿	yyaooa
澭	yyaova
蛹	yyiaao
俑	yyiaoi
镛	yyioov
佣	yyiuav
拥	yyiuua
永	yyoaau
踊	yyoiao
喁	yyoiav
咏	yyooaa
慵	yyooov
㶲	yyooua
雍	yyovaa
鄘	yyovai
庸	yyovav
饔	yyovio
痈	yyovua
壅	yyovvo
鲬	yyuaao
鳙	yyuaov
用	yyuavv
臃	yyuova
栐	yyvoaa
埇	yyvoao
墉	yyvoov
幺	yzaaoo
约	yzaaua
滧	yzaovu
姚	yzauuo
媱	yzauuo
妖	yzauuv
峣	yziava
崾	yziavi
药	yziiaa
耀	yzioao
铫	yziouo
钥	yziouu
摇	yziuuo
侥	yzivau
吆	yzoaao
谣	yzoauo
曜	yzoiao
窈	yzooaa
窅	yzooia
窑	yzoouv
咬	yzoovu
疟	yzovva
乐	yzuaiu
猺	yzuauo
鳐	yzuauo
邀	yzuioa
遥	yzuooa
繇	yzuoua
鹞	yzuoua
舀	yzuoui
爻	yzuouo
肴	yzuovu
徭	yzuuuo
腰	yzuvia
夭	yzuvuo
靿	yzvaaa
轺	yzvaau
尧	yzvavu
要	yzviau
杳	yzvoii
㙘	yzvovi
垚	yzvovo
珧	yzvvuo
瑶	yzvvuo
罪	zbiaiv
蕞	zbiioi
觜	zbivua
咀	zboiav
嘴	zboivi
最	zboivi
槜	zbviov
醉	zbviov
驺	zdaaua
陬	zdaivi
揍	zdiuvv
诹	zdoavi
邹	zduaai
鲰	zduavi
鄹	zdviai
走	zdvoiv
奏	zdvvvv
泽	zeaaov
则	zeaoii
帻	zeiavv
择	zeiuao
昃	zeoivu
咋	zeouvi
啧	zeovvi
舴	zeuuuv
迮	zeuvoa
笮	zeuvuv
箦	zeuvvv
赜	zevivv
仄	zevuii
责	zevvao
拶	zfiuaa
攒	zfiuuv
寁	zfoova
咱	zfouia
糌	zfouua
昝	zfuaoi
赞	zfuvao
簪	zfuvva
錾	zfvaio
暂	zfvaoi
趱	zfvouv
瓒	zfvvuv
甾	zhaaia
崽	zhiaia
仔	zhiaiv
灾	zhooou
宰	zhooov
哉	zhuooo
载	zhuova
栽	zhuovv
再	zhviai
在	zhvuvo
组	zjaaia
阻	zjaiia
崒	zjiaov
菹	zjiiai
俎	zjiiia
镞	zjioov
祖	zjoaia
诅	zjoaia
蹴	zjoiov
足	zjoivu
卒	zjovii
族	zjovuv
租	zjuvia
珇	zjvvia
淄	zkaaaa
缁	zkaaaa
甾	zkaaia
孖	zkaiai
孜	zkaiuv
子	zkaivv
滓	zkaooa
滋	zkaouv
姊	zkauua
渍	zkavvi
虸	zkiaai
仔	zkiaiv
眦	zkiaiv
嵫	zkiaou
茲	zkiiaa
茈	zkiiiv
锱	zkioaa
镃	zkioou
紫	zkivaa
赀	zkivao
龇	zkiviv
訾	zkivov
觜	zkivua
谘	zkoaov
呲	zkoivi
字	zkooai
嗞	zkoouv
兹	zkouaa
孳	zkouai
籽	zkouai
吱	zkouoa
资	zkovao
姿	zkovau
恣	zkovoa
咨	zkovoo
粢	zkovou
鲻	zkuaaa
自	zkuiav
秭	zkuvua
笫	zkuvua
辎	zkvaaa
鄑	zkviai
鼒	zkviia
髭	zkviiv
趑	zkvoov
梓	zkvovo
耔	zkvvai
阼	zlaiuv
岞	zliauv
坐	zliivo
挫	zliuii
撮	zliuoi
做	zliuoo
捽	zliuov
作	zliuvi
佐	zlivuv
祚	zloauv
唑	zloiiv
昨	zloiuv
嘬	zlooiv
怍	zloouv
座	zlovii
胙	zluuvi
笮	zluvuv
酢	zlviuv
左	zlvuvi
柞	zlvuvi
琢	zlvvvu
谮	znoava
怎	znuvoa
驵	zpaaia
牂	zpaiou
奘	zpaivu
赃	zpaoov
葬	zpiivu
藏	zpiivu
脏	zpuovu
臧	zpvuvi
综	zraaoo
缯	zraaou
赠	zraoou
罾	zriaou
锃	zrioov
憎	zrooou
鄫	zrouai
䎖	zrouao
曾	zrouoi
甑	zrouva
矰	zruvou
增	zrvoou
扎	zsiuaa
拶	zsiuaa
咱	zsouia
咋	zsouvi
咂	zsovia
杂	zsuavv
臜	zsuouv
匝	zsviai
砸	zsvuvi
缵	ztaauv
赚	ztaoou
钻	ztioiv
攥	ztiuuv
躜	ztoiuv
纂	ztuvia
贼	zwaovv
嶟	zwiaou
𨱔	zwioou
僔	zwiouv
撙	zwiuou
蹲	zwoiou
噂	zwoouv
遵	zwouoa
尊	zwouvi
鲗	zwuaao
鳟	zwuaou
樽	zwvouv
纵	zyaaii
综	zyaaoo
倧	zyiooa
偬	zyiuau
踪	zyoioo
宗	zyoovv
总	zyouoa
粽	zyouoo
疭	zyovii
腙	zyuooa
枞	zyviii
鬃	zyvioo
棕	zyvooa
鬷	zyvouo
蚤	zzaoia
澡	zzaooo
藻	zziiao
凿	zziiou
躁	zzoioo
早	zzoiuo
噪	zzoooo
慥	zzoouv
唣	zzouia
燥	zzouoo
糟	zzouvi
灶	zzouvo
皂	zzuiva
造	zzuvoa
簉	zzuvuv
遭	zzvioa
枣	zzvioo
𥖨	zzvuoo
璪	zzvvoo
